A.J	A.J
A.J.	A.J.
Aaron	アーロン
Abbate	アッバーテ
Abdul	アブドゥル
Abdullah	アブドゥラー
Abe	エイブ
Abercrombie	アバークロムビー
Abercrombie	エイバークロンビー
Abiamiri	アビアミリ
Abitante	アビタンテ
Abner	アブナー
Abney	アブニィ
Aboushi	アボウシ
Abraham	エイブラハム
Abraham	エイブレアム
Abram	エイブラム
Abrams	エイブラムズ
Abreu	アブレイユ
Abreu	マドソン
Abron	エイブロン
Accardo	アカルド
Accorsi	アコーシ
Acker	アッカー
Ackerley	アッカーリー
Acosta	アコスタ
Adalius	アダリアス
Adam	アダム
Adamle	アダムル
Adams	アダムズ
Addae	ウダイ
Addai	アダイ
Adderley	アダリー
Ade	エイド
Adell	アデル
Ademiluyi	アデミルイ
Aden	エイデン
Adewale	アデワレ
Adeyanju	エイドヤンジュ
Adibi	アディビ
Adimchinobe	アディムチノービ
Adisa	アディサ
Adjei	アジェイ
Adkisson	アドキソン
Adolphus	アドルファス
Adrian	エイドリアン
Adrien	エイドリアン
Aeneas	アニーアス
Agnone	アニョーネ
Ahmaad	アマード
Ahmad	アーマッド
Ahman	アーマン
Ahmard	アーマッド
Ahmed	アーメイド
Ahouse	アハウス
Ahtyba	アティバ
AhYou	アーユー
Aiello	アイエロ
Aiken	エイケン
Aikens	エイキンス
Aikman	エイクマン
Ailan	アイラン
Ainge	エインジ
Ainsworth	エインズワース
Airese	アイリーズ
Ajayi	アジャイ
Akah	エイカー
Akbar	アクバー
Akeem	アキーム
Akers	エイカーズ
Akerstrom	エイカーストロム
Aki	エイキ
Akili	アキリ
Akin	エイキン
Akins	エイキンス
Akwasi	アクワシ
Al	アル
Alabi	アラービ
Alailefaleula	アライーレイファレイオーラ
Alain	アライン
Alalampi	アラランピ
Alama-Francis	アラマフランシス
Alan	アラン
Albaladejo	アルバラデホ
Albers	アルバース
Albert	アルバート
Albright	オルブライト
Alcorn	アルコーン
Aldridge	オルドリッジ
Alejandro	アレハンドロ
Alex	アレックス
Alexander	アレグザンダー
Alexej	アレクセイ
Alexi	アレクシ
Alexis	アレクシス
Alfonseca	アルフォンセカ
Alfonso	アルフォンソ
Alford	アルフォード
Alfred	アルフレッド
Alfredo	アルフレード
Alfredo	アルフレド
Alge	アルジー
Ali	アリ
Alic	アリック
Alinen	アリネン
Allan	アラン
Alleman	アレマン
Allen	アレン
Allison	アリソン
Allred	オールレッド
Allyn	アレン
Almond	アーモンド
Alomar	アロマー
Alonso	アロンソ
Alonzo	アロンゾ
Alosi	アローシ
Alou	アルー
Alphonse	アルフォンス
Alphonso	アルフォンソ
Alshermond	アルシャーモンド
Alston	オルストン
Alstott	オルストット
Alt	オルト
Alterraun	アルテラン
Alton	アルトン
Alvarez	アルバレス
Alvin	アルヴィン
Alvis	アルヴィス
Alworth	オルワース
Amani	アマニ
Amano	アマノ
Amaro	アマロ
Amato	アーマート
Ambrose	アンブロウズ
Ameche	アメチー
Amey	エイミー
Amezaga	アメサガ
Amilcar	アミルカー
Amir	アミール
Amobi	アモービ
Amon	エイモン
Amos	エイモス
Amundson	アマンドソン
Amy	エイミー
Anam	ウノム
Anders	アンダース
Andersen	アンダーセン
Anderson	アンダーソン
Andino	アンディーノ
Andra	アンドレイ
Andrae	アンドレイ
Andre	アンドレ
Andre'	アンドレ
Andrei	アンドレイ
Andres	アンドレス
Andrew	アンドリュー
Andrew	アンドルー
Andrews	アンドリューズ
Andrus	アンドラス
Andruw	アンドルー
Andruzzi	アンドゥルッツィ
Andy	アンディ
Ane	アネイ
Anelli	アネリ
Angel	アンヘル
Angel	エンジェル
Angelo	アンジェロ
Angulo	アングーロ
Anibal	アニバル
Anoai	アヌワイー
Anquan	アンクワン
Ansu-Yeboah	アンスイェボー
Anthony	アンソニー
Antoine	アントワン
Antoineo	アントワーノ
Anton	アントン
Antonio	アントニオ
Antonopulos	アントノピュロス
Antowain	アントワン
Antrel	アントレル
Anttaj	アンタージ
Antuan	アントワン
Antwaan	アントワン
Antwain	アントワン
Antwan	アントワン
Antwaun	アントワン
Antwon	アントワン
Anwar	アンウォー
Appel	アペル
Applewhite	アップルホワイト
Aquino	アキノ
Araguz	アラガス
Aramis	アラミス
Arceneaux	アーセンアックス
Archer	アーチャー
Archibald	アーチボールド
Archie	アーチー
Archuleta	アーチュレッタ
ArDarius	アーデアリウス
Arellanes	アレラネス
Arian	アリアン
Arians	アリアンズ
Aric	エリック
Arkee	アーキー
Arlen	アーレン
Arline	アーライン
Arliss	アーリス
Armando	アルマンド
Armas	アーマス
Armey	アーミー
Armon	アーモン
Armstead	アームステッド
Armstrong	アームストロング
Arnaz	アーナズ
Arnett	アーネット
Arnie	アーニー
Arnold	アーノルド
Arnoux	アルヌー
Arnsparger	アーンスパーガー
Aromashodu	アロマショドゥ
Arrington	アリントン
Arrion	アリオン
Arron	アロン
Arroyo	アローヨ
Art	アート
Arth	アース
Arthur	アーサー
Artie	アーティー
Artis	アーティス
Artose	アトウズ
Artrell	アートレル
ArtRooney	アート
Artsem	アルツェム
Arturo	アートゥロ
Asante	アサンテ
Ascanio	アスカニオ
Asdrubal	アスドルバル
Ashe	アッシュ
Ashlan	アシュラン
Ashlee	アシュリー
Ashley	アシュリー
Ashton	アシュトン
Ashworth	アシュワース
Asiata	アジアータ
Askew	アスキュー
Asomugha	アソムーガ
Atari	アタリ
Ataveus	アタヴェウス
Atiyyah	アティヤー
Atkins	アトキンス
Atkinson	アトキンソン
Atlas	アトラス
Atogwe	アトグイ
Atwater	アトウォーター
Aubrayo	オーブレイヨ
Aubrey	オーブリー
Augie	オウジー
Aumavae	アウマバエ
Aundrae	オンドレイ
Aurelien	オレリアン
Ausmus	オースマス
Austin	オースティン
Austine	オースティン
Avant	アヴァン
Aveion	アヴェイオン
Avery	エイヴリー
Awasom	エイワーサム
Ayala	アヤラ
Ayanbadejo	アヤンバデーホ
Aybar	アイバー
Ayo	アヨ
Ayodele	エイデル
Ayoob	アヨーブ
Azumah	アズマー
Az-Zahir	アッザヒア
Azzarelli	アザレリ
B.J	B.J
B.J.	B.J
B.J.	B.J.
Baas	バース
Babatunde	ババトゥーンデイ
Babb	バブ
Babers	ベイバーズ
Babich	バビッチ
Babin	バビン
Babineaux	バビノー
Bacchus	バッカス
Backe	バック
Backus	バッカス
Bacon	ベイコン
Bacsik	バクシック
Badger	バッジャー
Baez	バイエズ
Baggs	バグズ
Bagley	バグリー
Bagwell	バグウェル
Bailey	ベイリー
Bain	ベイン
Bajakian	バジャキアン
Bajema	バジェマ
Bakari	バカリー
Baker	ベイカー
Baker	ベーカー
Bako	バーコ
Baldinger	バルディンガー
Baldwin	ボールドウィン
Bale	ベイル
Balentien	バレンティン
Balfour	バルフォア
Ball	ボール
Ballantyne	バランタイン
Ballard	バラード
Bam	バム
Banaszak	バナスザック
Banko	バンコ
Banks	バンクス
Bankston	バンクストン
Bannan	バンナン
Banner	バナー
Bannister	バニスター
Banta	バンタ
Banta-Cain	バンターケイン
Barajas	バラハス
Baraka	ビュロック
Barber	バーバー
Barbre	バーバー
Barclay	バークレイ
Barfield	バーフィールド
Barker	バーカー
Barkley	バークリー
Barksdale	バークスデイル
Barlow	バーロウ
Barnaby	バーナビー
Barnes	バーンズ
Barnett	バーネット
Barney	バーニー
Barnhardt	バーンハルト
Barnhart	バーンハート
Barnidge	バーニッジ
Barone	バローネ
Barone	バローン
Barr	バー
Barret	バレット
Barrett	バーレット
Barrett	バレット
Barrick	バリック
Barringer	バーリンジャー
Barron	バーロン
Barron	バロン
Barrow	バロウ
Barry	バリー
Bart	バート
Barta	バルタ
Bartee	バーティー
Bartell	バーテル
Bartelstein	バーテルスタイン
Barthelmes	バースールメス
Bartlett	バートレット
Bartley	バートリー
Bartolozzi	バルトロッツィ
Barton	バートン
Bartrum	バートラム
Basak	バサク
Basanez	バスアネイ
Bashir	バシーア
Baskett	バスケット
Basler	バスラー
Bass	バス
Bassey	バシー
Bastian	バスティアン
Bastin	バスティン
Batch	バッチ
Bates	ベイツ
Batista	バティスタ
Batiste	バティスト
Battle	バトル
Battles	バトルズ
Bauer	バウアー
Baugh	ボー
Baugher	ボッガー
Bauman	バウマン
Bautista	ボーティスタ
Bavaro	バヴァロ
Baxter	バクスター
Bay	ベイ
Baylark	ベイラーク
Bayless	ベイレス
Bayliss	ベイリス
Bazardo	バザルド
Bazuin	バザイン
Beach	ビーチ
Beachum	ビーチャム
Beake	ビーク
Beamer	ビーマー
Bear	ベア
Beasley	ビーズリー
Beason	ビーソン
Beathard	ベサード
Bech	ベック
Becht	ベクト
Beck	ベック
Beckett	ベケット
Beckham	ベッカム
Bedell	ベデル
Beekman	ビークマン
Beightol	ベックタル
Beisel	ベイゼル
Beitia	ベイティア
Belichick	ベリチック
Belisle	ベライル
Bell	ベル
Bellamy	ベラミー
Belliard	ベリヤード
Bellore	ベロア
Belser	ベルサー
Belton	ベルトン
Beltran	ベルトラン
Ben	ベン
Benard	ベイナード
Bender	ベンダー
Benekos	ブーネッコース
Benetka	ベネトカ
Benirschke	ベナーシュキー
Benitez	ベニテス
Benjamin	ベンジャミン
BenJarvus	ベンジャーバス
Benji	ベンジー
Bennett	ベネット
Bennie	ベニー
Benny	ベニー
Benoit	ブノワ
Benoit	ベノイト
Bensel	ベンゼル
Benson	ベンソン
Bentley	ベントリー
Benton	ベントン
Berchtold	バーチトールド
Bercich	バーシック
Berg	バーグ
Bergen	バーゲン
Bergendahl	ベリエンダール
Berger	バーガー
Bergeron	バージェロン
Bergheim	ベルクハイム
Bergman	バーグマン
Bergmann	バーグマン
Bergstrom	ベルグストロム
Beriault	ベリーオウ
Berkman	バークマン
Berlanga	ベルランガ
Berlin	バーリン
Bernadeau	ベルナンドー
Bernard	バーナード
Bernardo	バーナード
Bernie	バーニー
Bernstein	バーンスタイン
Berrian	ベリアン
Berry	ベリー
Berryman	ベリーマン
Bert	バート
Berthelsen	ベアデルセン
Berton	バートン
Bertrand	バートランド
Bess	ベス
Best	ベスト
Betancourt	ベタンコート
Bethea	ベセイ
Bethel	ベセル
Betters	ベターズ
Bettis	ベティス
Bettridge	ベトリッジ
Betts	ベッツ
Beuerlein	バーライン
Bevell	ベヴェル
Beverly	ビヴァリー
Bhawoh	バウォウ
Bibla	ビブラ
Bickerstaff	ビッカースタッフ
Bicknell	ビックネル
Biddle	ビドル
Bidwell	ビドウェル
Bidwill	ビドウィル
Bienemann	ビーネマン
Bieniemy	ビエネミー
Bierria	ビエリア
Biff	ビフ
Bigbie	ビグビー
Bigby	ビグビー
Biggio	ビジオ
Biggs	ビッグス
Bihl	ビール
Bilal	ビラル
Bilbo	ビルボ
Biletnikoff	ビレトニコフ
Bill	ビル
Billick	ビリック
Billy	ビリー
BillyRay	ビリーレイ
Bimper	ビンパー
Bing	ビング
Bingham	ビンガム
Binn	ビン
Birdine	バーディン
Biren	バイロン
Birk	バーク
Birkins	バーキンス
Birmingham	バーミンガム
Bironas	ビロナス
Birren	ビレン
Bischoff	ビショフ
Bisciotti	ビシャティー
Bishop	ビショップ
Bjork	ビョーク
Blache	ブラーク
Black	ブラック
Blackburn	ブラックバーン
Blackmon	ブラックモン
Blackstock	ブラックストック
Blackwell	ブラックウェル
Blackwood	ブラックウッド
Blade	ブレイド
Blades	ブレイズ
Blagman	ブラーグマン
Blaine	ブレイン
Blair	ブレア
Blake	ブレイク
Blake	ブレーク
Blakley	ブレイクリー
Blalock	ブレイロック
Blalock	ブレーロック
Blanchard	ブランチャード
Blanco	ブランコ
Blanda	ブランダ
Blank	ブランク
Blanton	ブラントン
Blaylock	ブレイロック
Bledsoe	ブレッドソー
Blevins	ブレヴィンズ
Blidi	ビリディ
Bliss	ブリス
Blizzard	ブリザード
Block	ブロック
Blomvall	ブロンヴァル
Bloom	ブルーム
Bloomquist	ブルームキスト
Blount	ブラウント
Blue	ブルー
Bly	ブライ
Bo	ボー
Board	ボード
Bob	ボブ
Bobbie	ボビー
Bobby	ボビー
Bober	ボウバー
Bockwoldt	ボックワルド
Bodden	ボデン
Bodiford	ボディフォード
Body	ボディ
Boerigter	ボーリグター
Boger	ボーガー
Bogle	ボウグル
Bohanon	ボハノン
Bohnet	ボーネット
Bohren	ボーレン
Boiman	ボイマン
Bolar	ボーラー
Bolden	ボウルデン
Boldin	ボウルディン
Boley	ボーリー
Boller	ボウラー
Bollinger	ボウリンジャー
Bolston	ボルストン
Bolton	ボルトン
Bonamego	ボナメイゴ
Bonderman	ボンダーマン
Bonner	ボナー
Bonnette	ボネット
Bonnie	ボニー
Bonser	ボンサー
Bonsiewicz	ボンシーヴィッチ
Boo	ブー
Boof	ブーフ
Booker	ブッカー
Bookman	ブックマン
Boomer	ブーマー
Boone	ブーン
Booth	ブース
Boothe	ブース
Booty	ブーティ
Boras	ボラス
Borkowski	ボルコウスキー
Bornstein	ボーンスタイン
Borowski	ボロウスキー
Boschetti	ボーシェッティ
Boselli	ボセッリ
Bosher	ボシャー
Boss	ボス
Boston	ボストン
Botts	ボッツ
Boudreau	ボードロー
Bouknight	ボーナイト
Boulware	ボウルウェア
Bouman	バウマン
Bourke	バーク
Bourn	ボーン
Bowden	ボウデン
Bowe	ボウ
Bowen	ボウエン
Bowen	ボーエン
Bowenkamp	ボウエンキャンプ
Bowens	ボウエンズ
Bowers	バワーズ
Bowie	ボウイ
Bowlen	ボウレン
Bowles	ボウルズ
Bowman	ボウマン
Boyd	ボイド
Boyer	ボイヤー
Boyer	ポイヤー
Boykin	ボイキン
Boyko	ボイコ
Bozeman	ボーズマン
Brace	ブレイス
Bracey	ブレイシー
Brackenridge	ブラッケンリッジ
Brackens	ブラッケンズ
Brackett	ブラケット
Brackins	ブラッキンズ
Bracy	ブレイシー
Brad	ブラッド
Braden	ブレイデン
Bradford	ブラッドフォード
Bradie	ブレイディ
Bradlee	ブラッドリー
Bradley	ブラッドリー
Bradshaw	ブラッドショー
Bradway	ブラッドウェイ
Brady	ブレイディ
Bragg	ブラッグ
Braham	ブレアム
Bramlet	ブラムレット
Branch	ブランチ
Brandon	ブランドン
Brandt	ブラント
Brannon	ブラノン
Brant	ブラント
Bratkowski	ブラトカウスキー
Bratton	ブラットン
Braun	ブラウン
Braxton	ブラクストン
Bray	ブライ
Bray	ブレイ
Brayan	ブライアン
Braylon	ブレイロン
Brayton	ブレイトン
Brazell	ブラゼール
Brazen	ブレイズン
Brazile	ブラジル
Breaston	ブリーストン
Breaux	ブロウ
Breeden	ブリーデン
Brees	ブリーズ
Brendan	ブレンダン
Brendel	ブレンデル
Brendon	ブレンドン
Brennan	ブレナン
Breno	ブレノ
Brent	ブレント
Brentson	ブレンツン
Bresnahan	ブレズナハン
Bret	ブレット
Brett	ブレット
Brewer	ブルーワー
Brewster	ブルースター
Brian	ブライアン
Brick	ブリック
Bridges	ブリッジズ
Bridgewater	ブリッジウォーター
Brielmaier	ブリールマイアー
Brien	ブライエン
Briggs	ブリグズ
Brightful	ブライトフル
Brimmer	ブリマー
Brinson	ブリンソン
Brisbane	ブリズベイン
Brisiel	ブリシール
Brisly	ブリズリー
Brister	ブリスター
Bristol	ブリストル
Britt	ブリット
Britton	ブリットン
Broadway	ブロードウェイ
Brocato	ブロケイト
Brock	ブロック
Brockington	ブロッキントン
Broderick	ブロデリック
Brodie	ブローディ
Brodney	ブロウドニー
Brodrick	ブロドリック
Brodsky	ブロツキー
Brohm	ブローム
Bromell	ブロメル
Bronko	ブロンコ
Bronson	ブロンソン
Brook	ブルック
Brooking	ブルッキング
Brooks	ブルックス
Broughton	ブロートン
Broussard	ブローサード
Brown	ブラウン
Browne	ブラウン
Browner	ブラウナー
Browning	ブラウニング
Brubaker	ブルベイカー
Bruce	ブルース
Brudzinski	ブルジンスキー
Bruener	ブルーナー
Brunell	ブルネル
Bruntlett	ブルントレット
Bruschi	ブルースキー
Bryan	ブライアン
Bryant	ブライアント
Bryce	ブライス
Bryson	ブライソン
Brzezinski	バゼジンスキー
Bua	ブア
Bubba	バッバ
Bubby	バビー
Bubin	ブービン
Buchanan	ブキャナン
Buchanon	ブキャナン
Buches	ビューキス
Buchholz	バックホルツ
Buck	バック
Buckhalter	バックホルター
Buckley	バックリー
Buckner	バックナー
Bud	バド
Budde	ブッディ
Buddy	バディ
Buehrle	バーリー
Buenning	ブエニング
Bugel	ビューゲル
Buggs	バグズ
Buhl	ブール
Bukvich	バクビッチ
Bulger	バルジャー
Bullington	ブリングトン
Bullitt	ブリット
Bullocks	バロックス
Bullough	ブロー
Bulluck	バラック
Bulman	バルマン
Bum	バム
Bunce	バンス
Bunkley	バンクリー
Buoniconti	ブオニコンティ
Burchette	バーチェット
Burford	バーフォード
Burgess	バージェス
Burgsmuller	ブルクスミュラー
Burke	バーク
Burkholder	バークホールダー
Burl	バール
Burleson	バールソン
Burnett	バーネット
Burns	バーンズ
Burrell	バレル
Burres	バレス
Burress	バレス
Burris	バリス
Burton	バートン
Bus	バス
Buscher	ブッシャー
Bush	ブッシュ
Bushrod	ブッシュロッド
Busing	ビーシング
Buster	バスター
Butch	ブッチ
Butchie	ブッチー
Butker	バッカー
Butkus	バトカス
Butler	バトラー
Byars	バイアーズ
Byner	バイナー
Bynum	バイナム
Byrd	バード
Byrdak	バーダック
Byrne	バーン
Byron	バイロン
Byrum	バイラム
C.C.	C.C.
Ｃ.J	Ｃ.J
C.J.	Ｃ.J
C.J.	C.J.
C.O.	C.O.
Cabel	カベル
Cable	ケイブル
Cabrera	カブレラ
Cadillac	キャデラック
Caesar	シーザー
Cage	ケイジ
Cain	ケイン
Cal	カル
Calahan	キャラハン
Caldwell	コールドウェル
Caleb	カリブ
Caleb	カレブ
Caleb	ケイレブ
Calen	カレン
Calero	カレーロ
Calhoun	カルホーン
Cali	カリ
Calico	カリーコ
Callahan	キャラハン
Calmus	カルマス
Calvin	カルヴィン
Cam	カム
Camarillo	カマリーロ
Cameron	キャメロン
Campbell	キャンベル
Campen	キャンペン
Campillo	グリーン
Campo	カンポ
Campusano	キャンプサーノ
Canadeo	キャナデオ
Cannon	カノン
Cano	カノー
Canonico	カノニコ
Canter	キャンター
Cantu	カントゥ
Canty	キャンティ
Capellan	カペラン
Capers	ケイパーズ
Capiraso	カピラソ
Capizzi	カピッツィ
Cappelletti	カペレッティ
Capps	キャップス
Capshaw	キャプショー
Captain	キャプテン
Capuano	カプアーノ
Carberry	カーベリー
Carey	ケアリー
Cargile	カーガイル
Carhart	カーハート
Carl	カール
Carlisle	カーライル
Carl-Johan	カールヨハン
Carlos	カルロス
Carlos	ルロス
Carlton	カールトン
Carlyle	カーライル
Carmen	キャメロン
Carmichael	カーマイケル
Carmody	カーモディ
Carmona	カーモナ
Carnahan	カーナハン
Carnell	カーネル
Carney	カーニー
Carolan	キャロラン
Carollo	カローロ
Carothers	キャロザーズ
Carpenter	カーペンター
Carr	カー
Carrier	キャリアー
Carriker	キャリッカー
Carrington	キャリントン
Carroll	キャロル
Carroo	カルー
Carson	カーソン
Carstens	カーステンズ
Carswell	カーズウェル
Carter	カーター
Carthen	カーセン
Carthon	カーソン
Cartwright	カートライト
Carvajal	カーバハル
Cary	ケアリー
Casanova	カサノヴァ
Case	ケイス
Casey	ケイシー
Casey	ケーシー
Cash	キャッシュ
Casilla	カシーヤ
Casillas	カシラス
Cason	ケイソン
Casper	キャスパー
Cass	カス
Cassady	キャサディ
Cassel	キャッセル
Casserly	キャサリー
Cassity	キャシティ
Casson	キャッソン
Castaneda	カスタネーダ
Castille	カスティール
Castillo	カスティーヨ
Castillo	カスティーロ
Castro	カストロ
Casullo	カスーロ
Catalanotto	カタラノット
Catanese	カタニーズ
Catanzaro	カタンザーロ
Cato	カトー
Cato	ケイトウ
Caudill	コーディル
Caulley	コーリー
Cavanaugh	キャヴァノー
Caver	ケイヴァー
Cavka	カヴカ
Caylor	ケイラー
Cecil	シーシル
Cecil	セシル
Cedeno	セデーニョ
Cedric	セドリック
Cedrick	セドリック
Celek	セリック
Celestin	セレスティン
Cesaire	セゼア
Cesar	シーザー
Chacon	チャコーン
Chad	チャド
Chaisson	チェイソン
Chamberlain	チェンバレン
Chamberlain	チャンバーレイン
Chamberlin	チャンバーリン
Chambers	チェインバーズ
Chamblin	チャンブリン
Champ	チャンプ
Chan	チャン
Chancellor	キャンセラー
Chandler	チャンドラー
Chaney	チェイニー
Chang	チャン
Channing	チャニング
Chansi	チャンシー
Chao	チャオ
Chaoran	チャオラン
Chapman	チャップマン
Chappell	チャペル
Charcandrick	チャーキャンドリック
Charles	チャールズ
Charleston	チャールストン
Charley	チャーリー
Charlie	チャーリー
Charlotte	シャーロット
Charlton	チャールトン
Charly	チャーリー
Charone	シャロン
Chartric	シャートリック
Chas	チャズ
Chase	チェイス
Chase	チェース
Chase	チャズ
Chatham	チャッサム
Chatman	チャットマン
Chaun	ショーン
Chauncey	チャーンシー
Chavez	チャベス
Chavous	チャヴァス
Chayut	チャイアット
Chaz	チャズ
Cheatwood	チートウッド
Cherilus	チェリラス
Cherry	チェリー
Chesson	チェッソン
Chester	チェスター
Chet	チェット
Chick	チック
Chickillo	チッキーロ
Chico	シーコ
Chidi	チディ
Chien-Ming	チェンミン
Chijioke	チージョーキー
Chike	チーケイ
Chila	シーラ
Childress	チルドレス
Chillar	チラー
Chinedum	シヌドゥーム
Chip	チップ
Chipper	チッパー
Choice	チョイス
Chone	チョーン
Chonn	チョン
Chow	チャウ
Chrebet	クレベット
Chris	クリス
Christensen	クリステンセン
Christian	クリスチャン
Christiansen	クリスチャンセン
Christoff	クリストフ
Christopher	クリストファー
Chuck	チャック
Chudzinski	シュジンスキー
Chukky	チャッキー
Chukwurah	チャクウラー
Chung	チャン
Church	チャーチ
Ciatrick	チャトリック
Cie	シー
Cieslak	シースラック
Cindrich	シンドリッチ
Cindy	シンディ
Cintron	シントロン
Cismesia	シスメージア
Ciurciu	シウーシウ
Clabo	クラボ
Clack	クラック
Clady	クレディ
Claiborne	クレイボーン
Clancy	クランシー
Clarence	クラレンス
Clarett	クラレット
Claridge	クレアリッジ
Clark	クラーク
Clarke	クラーク
Clary	クラリー
Claude	クロード
Claudio	クラウディオ
Claudius	クローディアス
Clausen	クラウセン
Clauss	クラウス
Claxton	クラクストン
Clay	クレイ
Clay	クレイトン
Clayborn	クレイボーン
Clayton	クレイトン
Cleeland	クリーランド
Clemens	クレメンス
Clement	クレメント
Clements	クレメンツ
Clemons	クレモンズ
Cleo	クリオ
Cletidus	クレティダス
Cletis	クレティス
Cleveland	クリーヴランド
Clevlen	クレブレン
Cliff	クリフ
Clifford	クリフォード
Clifton	クリフトン
Cline	クライン
Clinger	クリンガー
Clinkscale	クリンクスケール
Clint	クリント
Clinton	クリントン
Cloud	クラウド
Clowney	クラウニー
Clyde	クライド
Coady	コーディ
Coakley	コークリー
Coates	コーツ
Coats	コーツ
Cobb	コッブ
Cobbs	コッブス
Cochran	カックラン
Cochrane	カックラン
Coco	ココ
Cody	コウディ
Cody	コーディー
Cody	コディ
Cody	コディー
Coe	コー
Coffey	コフィ
Coffey	コフィー
Cofield	コーフィールド
Coghill	コギル
Cohen	コーエン
Coiner	コイナー
Colangelo	コランジェロ
Colbert	コルバート
Colburn	コルバーン
Colby	コルビー
Colclough	コークリー
Cole	コウル
Cole	コール
Coleman	コウルマン
Coles	コウルズ
Coley	コウリー
Colin	コリン
Collazo	コラーゾ
Colledge	コレッジ
Colletto	コレット
Collie	コリー
Collier	コリアー
Collins	コリンズ
Collinsworth	コリンズワース
Colman	コールマン
Colmer	コルマー
Colombo	コロンボ
Colome	コロメ
Colon	コロン
Colquitt	コルキット
Colston	コルストン
Colt	コルト
Colton	コルトン
Colvin	コルヴィン
Combs	コウムズ
Conaty	カナティ
Concannon	コンキャノン
Concetion	コンセション
Condo	コンドウ
Condoleezza	コンドリーザ
Condon	コンドン
Condren	コンドレン
Condrey	コンドリー
Conine	コーナイン
Conley	コンリー
Connell	コーネル
Connelly	コネリー
Conner	コナー
Conners	コナーズ
Connolly	コノリー
Connor	コナー
Connot	コノット
Conor	コナー
Conover	コノヴァー
Conrad	コンラッド
Considine	コンシディン
Constantin	コンスタンティン
Contreras	コントレラス
Conway	コンウェイ
Conwell	カンウェル
Conzelman	コンツェルマン
Cook	クック
Cooke	クック
Cooley	クーリー
Cooper	クーパー
Cope	コープ
Copeland	コープランド
Coples	コプルス
Coplin	コプリン
Copper	コッパー
Cora	コーラ
Cordell	コーデル
Cordero	コルデロ
Cordill	コーディル
Cordova	コルドヴァ
Cordrea	コードレア
Cordy	コーディー
Corey	コーリー
Corey	コリー
Corky	コーキー
Cormier	コーミエ、
Cornelius	コーネリアス
Cornell	コーネル
Corner	コナー
Cornish	コーニッシュ
Cornrich	コーンリッチ
Corral	コラル
Correll	コレール
Corrente	コレント
Corso	コルソ
Cortez	コルテス
Cortland	コートランド
Corvey	コルヴェイ
Corwin	コーウィン
Cory	コーリー
Coryell	コリエル
Cosey	コウジー
Coslet	コスレット
Costa	コスタ
Costanzo	コスタンツォ
Coste	コステ
Coston	コストン
Cota	コータ
Cotchery	コッチェリー
Cottrell	コトレル
Couch	カウチ
Coughlin	コフリン
Counsell	カウンセル
Couper	クーパー
Courson	コーソン
Courtney	コートニー
Courtright	コートライト
Cousin	カズン
Cousineau	クージノー
Coutlangus	コートラングス
Covert	カヴァート
Cowart	カワート
Cowher	カウワー
Cowsette	カウセット
Cox	コックス
Coy	コイ
Coyer	コイヤー
Crabtree	クラブツリー
Craft	クラフト
Crafts	クラフツ
Craig	クレイグ
Crain	クレイン
Cramer	クレイマー
Craphonso	クラフォンソ
Crawford	クロフォード
Crayton	クレイトン
Crede	クリーディ
Cregg	クレッグ
Crennel	クレネル
Cribbs	クリブズ
Criner	クライナー
Cris	クリス
Crisler	クリスラー
Crisp	クリスプ
Cristian	クリスチャン
Crocker	クロッカー
Crockett	クロケット
Cromartie	クロマティ
Cronin	クローニン
Croom	クルーム
Crosby	クロスビー
Cross	クロス
Crow	クロウ
Crowder	クロウダー
Crowell	クロウェル
Croyle	クロイル
Crum	クラム
Crumpler	クランプラー
Cruz	クルーズ
Cryer	クライヤー
Csonka	ゾンカ
Cuddyer	カダイアー
Cudzik	カドジック
Culberson	クルバーソン
Culbert	カルバート
Cullen	カレン
Culp	カルプ
Culpepper	カルペッパー
Culton	カルトン
Culver	カルヴァー
Cumberland	カバーランド
Cumberland,	ジェフ
Cumbie	カムビー
Cummings	カミングス
Cundiff	カンディフ
Cuneyt	ジュネイト
Cunningham	カニンガム
Cupito	クーピト
Curl	カール
Curley	カーリー
Curome	クローム
Currie	カリー
Curry	カリー
Curt	カート
Curtin	カーティン
Curtis	カーティス
Curvey	カーヴィー
Cushing	クッシング
Cust	カスト
Cutler	カトラー
D.D.	D.D.
D.J.	D.J.
Daboll	ダボール
Dada	ダダ
Dadi	ダディ
Daft	ダフト
Dagunduro	ドガンドゥーロ
Dahl	ダール
Dahlquist	ドルクエスト
Daimon	デイモン
Daisher	デイシャー
Dakota	ダコタ
Dale	デイル
Dallas	ダラス
Dalrymple	ダーリンプル
Dalton	ダルトン
Damane	ダメイン
Damarius	ダマリアス
Damaso	ダマソ
Dameane	デイミアン
Dameyune	デイミエン
Damian	ダミアン
Damien	ダミアン
Damion	ダミオン
Damione	デイミアン
Damon	デイモン
Damon	デーモン
Damontae	Damontae
Dan	ダン
Dana	ダナ
Dane	デイン
D'Angelo	ダンヘロ
Danieal	ダニエル
Daniel	ダニエル
Daniel	ダン
Daniels	ダニエルズ
Danks	ダンクス
Danny	ダニー
Dansby	ダンズビー
Dante	ダンテ
D'Anthony	ディーアンソニー
D'Anton	ダントン
Dantonio	ダントニオ
Dantzler	ダンツラー
Danys	ダニス
Darby	ダービー
Darche	ダーシュ
Darcy	ダーシー
Daren	ダレン
Dareus	ダリウス
Darian	ダリアン
Daric	ダリック
Darilek	ダリレク
Darin	ダリン
Dario	ダリオ
Darius	ダリアス
Darling	ダーリング
Darnell	ダーネル
Darnerien	ダーネリアン
Darrell	ダレル
Darrelle	ダレル
Darren	ダレン
Darrent	ダレント
Darrien	ダリエン
Darrin	ダリン
Darrion	ダリオン
Darrius	ダリウス
Darron	ダロン
Darryl	ダリル
Darryll	ダリル
Darveau	ダーヴォ
Darwin	ダーウィン
Daryl	ダリル
Daryle	ダレル
Daryn	ダレン
DaShane	ダシェイン
DaShon	ダショーン
Dat	ダト
Datish	ダティッシュ
Daunta	ダンタ
Daunte	ダンテ
DaVanon	ダバノン
Dave	デイヴ
Dave	デーブ
Daven	ダヴェン
Davenport	ダヴェンポート
Davern	ダヴァーン
Davey	デイヴィー
David	デイヴィッド
David	デビッド
Davidson	デイヴィッドソン
Davidson	デービッドソン
Davies	デイビス
Davin	デイヴィン
Davis	デービス
Davon	ダヴォン
Davone	デボン
Dawan	ドワン
Dawkins	ドーキンス
Daws	ドース
Dawson	ドーソン
Day	デイ
Daylon	デイロン
Daymeion	デイミーアン
Dayne	デイン
D'Brickashaw	ドブリカショー
Deacon	ディーコン
Dean	ディーン
DeAndra	デアンドラ
DeAndre	デアンドレ
Deandre'	デアンドレ
DeAndrew	デアンドリュー
DeAngelo	デアンジェロ
De'Anthony	デアンソニー
De'Arrius	デアリウス
Dearth	ダース
DeAza	デアザ
DeBartolo	デバートロ
DeCamillis	デカミリス
Decker	デッカー
DeCori	デコリ
Dede	ディーディー
Dedric	デドリック
Dedrick	デドリック
Dee	ディー
Deek	ディーク
Deese	ディーズ
DeFelice	ディーファリース
DeFilippo	デフィリッポ
DeForest	デフォレスト
DeGennaro	ドゥジュネロ
Degory	デゴリー
DeGrate	ダグレイト
DeHaven	デヘイヴン
Deion	ディオン
DeJesus	デヘスス
DeJuan	デジュアン
Deke	ディーク
Dekker	デッカー
Del	デル
DeLamielleure	ドゥラムリア
Delanie	デレイニー
DeLawrence	デローレンス
Delbert	デルバート
Delcarmen	デルカーメン
Delgado	デルガド
DelGreco	デルグレコ
Delhomme	デローム
Deljuan	デルワン
Delmas	デルマス
Delmon	デルモン
DeLoach	デローチ
Deloatch	デローチ
DeLong	デロング
DelRio	デルリオ
Deltha	デルサ
DeLuca	デルーカ
DeMar	デマー
Demarcus	デマーカス
DeMario	デマリオ
Demaryius	デマリアス
DeMeco	デメコ
Demetric	デメトリック
Demetrin	デメトリン
Demetrius	デメトリアス
Demoff	デモフ
DeMontie	デモンティー
Demorrio	デモーリオ
Demps	デンプス
Dempsey	デンプシー
Dempster	デンプスター
DeMulling	デマリング
Denard	デナード
Denauld	デナウルド
Dendy	デンディ
Denman	デンマン
Dennard	デナード
Dennery	デナリー
Denney	デニー
Dennis	デニス
Dennison	デニソン
Denny	デニー
Dennys	デニース
Denorfia	デノーフィア
Dent	デント
Deon	ディオン
Deondri	デオンドリ
Deonte	ディオンテ
DeOssie	デオシー
DePalma	デパルマ
DePaula	デポーラ
DePriest	デプリースト
DeQawn	ディカウン
DeQuincy	ディクインシー
Deraney	ドゥレイニー
Derek	デレク
Derek	デレック
Derham	デルハム
Derick	デリック
Dermontti	ダーモンティ
Deron	デロン
DeRosa	デローサ
Derr	デア
Derreck	デリック
Derrek	デレク
Derrick	デリック
Derrius	デリアス
Derting	ダーティング
Deryck	デリック
DeSean	デショーン
DeShane	デシェイン
DeShaun	デショーン
DeShawn	デショーン
Deshea	デシェイ
Deshon	デショーン
Deslauriers	ドゥロリエイ
Desmond	デズモンド
Detmer	デトマー
Detron	デトロン
Detwiler	デトワイラー
Deuce	デュース
Deuce	ドゥーシー
Devale	デヴェイル
Devan	デヴァン
DeVante	ディバンティ
Devard	デヴァード
Devarick	デヴァリック
Devery	デヴェリィ
Devey	デヴィ
Devin	デヴィン
Devine	ディヴァイン
Devine	デヴァイン
DeVito	デヴィート
Devito	デビト
Devlin	デヴリン
Devoe	デヴォー
De'Vondre	デボンドレ
Devonta	デボンタ
Devonte	ドヴォンテイ
Devraun	デヴローン
DeVries	デヴリーズ
Dewane	ディウェイン
Dewayne	ディウェイン
Dexter	デクスター
Deyon	デイヨン
Dez	デズ
Dhani	ダーニー
Diamond	ダイアモンド
Diaz	ディアス
Diaz	ディアズ
Dibbles	ディブルズ
Dick	ディック
Dickens	ディケンズ
Dickerson	ディッカーソン
Dickson	ディクソン
Diehl	ディール
Dielman	ディールマン
Diem	ディーム
DiFelice	ディフェリス
Diggs	ディグズ
DiGiorgio	ディジョルジオ
Diles	ダイルズ
Dilfer	ディルファー
Dilger	ディルガー
Dillard	ディラード
Dillon	ディロン
DiMarco	ディマルコ
Dimitri	ディミトリ
DiNardo	ディナルド
Ding	ディン
Dingle	ディングル
Dinkins	ディンキンズ
Dino	ディーノ
Dinwiddie	ディンウィディー
Dion	ディオン
Dioner	ディオナー
DiPiero	ディピエロ
Dirk	ダーク
Dishman	ディッシュマン
Ditka	ディトカ
DiTrapano	ディトラパーノ
Dittoe	ディトー
Dixon	ディクソン
D'Juan	ダウォン
Dmitri	デミートリ
Doak	ドーク
Dobbins	ドビンズ
Dobbs	ドッブス
Doc	ドック
Docherty	ドゥカティ
Dockery	ドッカリー
Dockett	ドケット
Dodge	ダッジ
Doering	ドアリング
Dogra	ドグラ
Dohmann	ドーマン
Doleman	ドウルマン
Dom	ドム
Domanick	ドマニック
Domata	ドマタ
Domenik	ドメニク
Dominic	ドミニク
Dominique	ドミニーク
Dominique	ドミニク
Domonique	ドモニク
Don	ドン
Donahoe	ドナフー
Donahue	ドナヒュー
Donald	ドナルド
Donaldson	ドナルドソン
Donatell	ドナテール
Donnell	ドネル
Donnie	ドニー
Donny	ドニー
Donovan	ドノヴァン
Donovin	ドノヴィン
Dontari	ドンタリ
Dontarrious	ドンタリオス
Donte	ドンテイ
Donte'	ドンティ
Dontez	ドンテス
Dontrell	ドントレル
Dontrelle	ダントレル
Dontrelle	ドントレル
Dorais	ドライズ
Dorenbos	ドレンボス
Dorrell	ドレル
Dorsch	ドーシュ
Dorsett	ドーセット
Dorsey	ドーシー
Doss	ドス
Dotel	ドテール
Dotson	ドットソン
Doty	ドウティ
Doucet	ドーセット
Doug	ダグ
Dougherty	ドウアティ
Doughty	ダウティ
Douglas	ダグラス
Douglass	ダグラス
Doumit	ドゥミ
Douzable	ドゥーザブル
Downer	ダウナー
Downing	ダウニング
Downs	ダウンズ
Dozier	ドウジャー
D'Qwell	ディークウェル
Draft	ドラフト
Drake	ドレイク
Drame	ドレイム
Draper	ドレイパー
Drayton	ドレイトン
Dre'	ドレイ
Dreessen	ドリーセン
Drew	ドリュー
Drew	ドルー
Dri	ドライ
Drisan	ドライサン
Driver	ドライバー
Droege	ドロージ
Droughns	ドローンズ
Drouzon	ドローズン
Drummond	ドラモンド
Drushal	ドルーシャル
Duane	ドゥエイン
Duaner	デュアネル
Dub	ダブ
Ducasse	デュカス
Duce	デュース
Duchscherer	デュシェラー
Duckett	ダケット
Duckworth	ダックワース
Dudley	ダドリー
Duerson	デュアソン
Duff	ダフ
Duffner	ダフナー
Duffy	ダフィー
Dugan	デュガン
Duggan	デュガン
Duke	デューク
Dukes	デュークス
Dumas	ドゥーマ
Dumatrait	デュマトレイト
Dumervil	ドゥーマーヴィル
Dunbar	ダンバー
Duncan	ダンカン
Dungy	ダンジー
Dunn	ダン
Dunning	ダニング
Dunstan	ダンスタン
Dunta	ダンタ
Duper	デューパー
Durant	ドゥラント
Durbin	ダービン
Durde	デュルディ
Durham	ダーラム
Duron	デュロン
Dustin	ダスティン
Dusty	ダスティ
Dutton	ダットン
Duval	デュヴァル
Duvernay-Tardif	デューバネイ=ターディフ
Duvol	デュヴォル
Dvoracek	ドヴォルチェック
Dwain	ドゥウェイン
Dwaine	ドゥウェイン
Dwan	ドゥワン
Dwayne	ドゥウェイン
Dwight	ドワイト
Dyakowski	ダユカウスキー
Dye	ダイ
Dylan	ディラン
Dyshod	ディショッド
Dyson	ダイソン
E.J.	E.J.
Eakin	エイキン
Ealy	イーリー
Ean	イアン
Earl	アール
Earle	アール
Early	アーリー
Earnest	アーネスト
Earnie	アーニー
Earthwind	アースウィンド
Earvin	アーヴィン
Easley	イーズリー
Easlick	イースリック
Eason	イーソン
Easy	イージー
Eatman	イートマン
Eaton	イートン
Ebell	エベル
Eben	イーベン
Ebenezer	エベネザー
Echemandu	エチュマンデュ
Echols	エコルス
Eck	エック
Eckel	エケル
Ecker	エッカー
Economos	エコノモス
Ed	エド
Eddie	エディ
Eddins	エディンズ
Edds	エッズ
Edell	エデール
Edelman	エデルマン
Edgar	エドガー
Edgerrin	エジリン
Edgerton	エジャートン
Edinger	エディンガー
Edinson	エジソン
Edison	エディソン
Edmond	エドモンド
Edorian	エードリアン
Eduardo	エドゥアルド
Edward	エドワード
Edwards	エドワーズ
Edwin	エドウィン
Efe	エフエ
Efrem	エフレム
Ehinger	エーインガー
Ehren	ユーレン
Eiland	エイランド
Ekejiuba	エイケジゥーバ
Ekuban	エキュバン
Ekwerekwu	エックワーエックウー
Elam	イーラム
Eldra	エルドラ
Eldred	エルドレッド
Elgin	エルギン
Eli	イーライ
Eligwe	イーリグウェイ
Elijah	イライジャ
Elimimian	エリミミアン
Ellard	エラード
Eller	エラー
Ellick	エリック
Elling	エリング
Ellington	エリントン
Elliot	エリオット
Elliott	エリオット
Ellis	エリス
Ellison	エリソン
Elliss	エリス
Ellsbury	エルスベリー
Elmer	エルマー
Elroy	エルロイ
Elston	エルストン
Elton	エルトン
Elvin	エルヴィン
Elvis	エルヴィス
Elway	エルウェイ
Elwyn	エルウィン
Ely-Kelso	イーリーケルソ
Emanuel	エマニュエル
Embree	エンブリー
Emil	エミル
Emmanuel	エマニュエル
Emmitt	エミット
Emmons	エモンズ
Ena	イーナ
Encarnacion	エンカーナシオン
Endy	エンディ
Enemkpali	エネムパリ
Engelberger	エンゲルバーガー
Engelhard	インゲルハード
Engemann	エンジマン
English	イングリッシュ
Engram	エングラム
Enoch	エノック
Enoka	エノーカ
Enunwa	エヌンワ
Enzor	エンツォー
Ephraim	エフレイム
Epstein	エプスタイン
Erasmus	イラズマス
Eric	エリック
Erick	エリク
Erick	エリック
Erickson	エリクソン
Erik	エリック
Erin	エリン
Erlandson	エルランドソン
Ernest	アーネスト
Ernie	アーニー
Ernster	アーンスター
Erron	エロン
Erstad	アースタード
Ervin	アービン
Erving	アービング
Escobar	エスコバー
Escobar	エスコバル
Esera	エッセラ
Esiason	アサイアソン
Eslinger	イースリンガー
Esposito	エスポシート
Espy	イスパイ
Essex	エセックス
Estandia	エスタンディア
Esteban	エステバン
Estelle	エステール
Estes	エステス
Estime	エスタイム
Estrada	エストラーダ
Estrada	エストラダ
Ethan	イーサン
Etric	エトリック
Eubanks	ユーバンクス
Eugene	ユージーン
Euhus	ユーハス
Evan	イヴァン
Evan	エヴァン
Evans	エヴァンズ
Evans	エバンス
Everado	エヴェラード
Everest	エヴェレスト
Everett	エヴェレット
Everett	エベレット
Everette	エベレット
Everson	エヴァーソン
Evwaraye	エヴヴォーアイェイー
Ewbank	ユーバンク
Eyre	エア
Ezekiel	エズィキュアル
Ezra	エズラ
Faafetai	ファーフェタイ
Fabian	フェイビアン
Fabini	ファビーニ
Faggins	ファギンズ
Fahey	ファーヘイ
Faine	フェイン
Fair	フェア
Fairbanks	フェアバンクス
Fairchild	フェアチャイルド
Fairooz	フェルーツ
Fakhir	ファキーア
Faneca	ファニカ
Fanene	ファニーニ
Fargas	ファーガス
Farley	ファーリー
Farmer	ファーマー
Farnsworth	ファンズワース
Farr	ファー
Farrior	ファリアー
Farris	ファリス
Farwell	ファーウェル
Fasano	ファサーノ
Fasano	ファザーノ
Fason	ファソン
Fassel	ファセル
Fassitt	ファシット
Fatafehi	ファタフェヒ
Faulk	フォーク
Fauria	フォーリア
Faust	ファウスト
Fausto	ファウスト
Favors	フェイヴァーズ
Favre	ファーブ
Fayton	フェイトン
Feagles	フィーグルズ
Fede	フェデ
Federkeil	フェダーカイル
Feeley	フィーリー
Feely	フィーリー
Feierabend	フィーラベンド
Feldman	フェルドマン
Feliciano	フェリシアーノ
Felipe	フェリペ
Felix	フェリックス
Fells	フェルズ
Felton	フェルトン
Fenner	フェナー
Fenton	フェントン
Ferentz	フェアリンツ
Ferguson	ファーガソン
Fernandesz	フェルナンデス
Fernando	ファーナンド
Fernando	フェルナンド
Ferrante	フェランテ
Ferri	フェリ
Feula	フーラ
Fewell	フューエル
Fiammetta	フィアメッタ
Fichtner	フィクナー
Fick	フィック
Ficklin	フィックリン
Fiedler	フィードラー
Fielder	フィルダー
Fields	フィールズ
Fielkow	フィールカウ
Fife	ファイフ
Fifita	フィーフィータ
Figgins	フィギンズ
Figurs	フィギュアス
Fikse	フィクシー
Filani	フィラニ
Filip	フィリップ
Filipovic	フィリポビッチ
Finau	フィナウ
Fincher	フィンチャー
Fine	ファイン
Finke	フィンケ
Finks	フィンクス
Finley	フィンリー
Finn	フィン
Finnegan	フィネガン
Finneran	フィネラン
Finnerty	フィナティ
Fiore	フィオーレ
Fischer	フィッシャー
Fish	フィッシュ
Fisher	フィッシャー
Fisk	フィスク
Fiss	フィス
Fitch	フィッチ
Fitzgerald	フィッツジェラルド
Fitzhugh	フィッツヒュー
Fitzpatrick	フィッツパトリック
Fitzsimmons	フィッツシモンズ
Flacco	フラッコ
Flachs	フラックス
Flanagan	フラナガン
Flanigan	フラニガン
Fleck	フレック
Fleming	フレミング
Flemister	フレミスター
Flemming	フレミング
Fletcher	フレッチャー
Fletcher-Baker	フレッチャー
Flinn	フリン
Florence	フローレンス
Flores	フローレス
Flores	フローレズ
Florian	フロリアン
Flowers	フラワーズ
Floyd	フロイド
Flozell	フロゼール
Flutie	フルーティ
Flynn	フライン
Folau	フォーラウ
Foley	フォーリー
Foliaki	フォーリアキ
Folk	フォーク
Fonoti	フォノーティ
Fontel	フォンテル
Fontenot	フォンテノー
Fontenot	フォンテノット
Foote	フーツ
Footman	フットマン
Ford	フォード
Fordham	フォーダム
Fordyce	フォーダイス
Foreman	フォアマン
Forester	フォレスター
Forney	フォーニー
Forrest	フォレスト
Forte	フォーテ
Foschi	フォッチ
Foster	フォスター
Fouts	ファウツ
Fowler	ファウラー
Fox	フォックス
Foxworth	フォックスワース
Foxx	フォックス
Fraley	フレイリー
Frampton	フランプトン
Fran	フラン
France	フランス
Francies	フランシーズ
Francis	フランシス
Francisco	フランシスコ
Franco	フランコ
Francoeur	フランコーア
Frank	フランク
Frankel	フランケル
Frankie	フランキー
Franklin	フランクリン
Franks	フランクス
Franquelis	フランクエリス
Frantz	フランツ
Franz	フランツ
Fraser	フレイザー
Frasor	フレーザー
Frazier	フレイジャー
Fred	フレッド
Freddie	フレディ
Freddy	フレディ
Frederickson	フレデリクソン
Fredrick	フレッド
Fredrickson	フレドリクソン
Free	フリー
Freel	フリール
Freeman	フリーマン
Freeney	フリーニー
Freitas	フライタス
Frenchy	フレンチー
Frerotte	ファーロット
Frick	フリック
Friedman	フリードマン
Friehauf	フリーハウフ
Frierson	フライアーソン
Frisman	フリズマン
Fritsch	フリッチ
Fritz	フリッツ
Frome	フルーム
Frost	フロスト
Frostee	フロスティー
Fry	フライ
Fryar	フライヤー
Frye	フライ
Fuad	ファード
Fuamatu-Ma'afala	ファマトゥマファーラ
Fuchs	フックス
Fudge	ファッジ
Fuhrman	ファーマン
Fujita	フジタ
Fulcher	フルチャー
Fuller	フラー
Fulmer	フルマー
Fulton	フルトン
Fultz	フルツ
Funtaine	ファンテン
Fuqua	フュークワ
Furio	フリオ
Furrer	フラー
Furrey	ファリー
Gabbard	ギャバード
Gabbert	ギャバート
Gabe	ゲイブ
Gabriel	ゲイブリエル
Gaddis	ガディス
Gado	ガードウ
Gaffney	ギャフニー
Gafford	ギャフォード
Gage	ゲイジ
Gagne	ガニエ
Gagne-Marcoux	ガニエマークー
Gailey	ゲイリー
Gaines	ゲインズ
Gaither	ゲイザー
Galarraga	ガララーガ
Gale	ゲイル
Galen	ガレン
Gallardo	ギャラード
Gallery	ギャラリー
Gallishaw	ガリショー
Galloway	ギャロウェイ
Gambill	ギャンビル
Gamble	ギャンブル
Gamez	ガメス
Gammon	ギャモン
Ganaway	ギャナウェイ
Gandy	ギャンディ
Ganji	ガンジ
Gannon	ギャノン
Gant	ガント
Ganther	ギャンサー
Gao	ガオ
Garay	ギャレイ
Garcia	ガルシア
Garcon	ガーソン
Gardent	ガーデン
Gardner	ガードナー
Gardocki	ガードッキ
Garko	ガーコ
Garland	ガーランド
Garmon	ガーモン
Garnell	ガーネル
Garner	ガーナー
Garnes	ガーネス
Garrard	ギャラード
Garret	ギャレット
Garrett	ギャレット
Garrick	ギャリック
Garrison	ギャリソン
Garry	ガリー
Garth	ガース
Gary	ゲイリー
Gary	ゲリー
Garza	ガーザ
Gase	ガーゼ
Gash	ガッシュ
Gasperson	ガスパーソン
Gastineau	ガスティノー
Gaston	ガストン
Gates	ゲイツ
Gatewood	ゲイトウッド
Gathright	ガスライト
Gatlin	ガトリン
Gatski	ギャツキ
Gattis	ガティス
Gaudin	ゴーディン
Gause	ゴーズ
Gavin	ガビン
Gavin	ギャヴィン
Gay	ゲイ
Gayer	ゲイヤー
Gbaja-Biamila	バジャビアミラ
Geathers	ジャザース
Geisinger	ガイシンガー
Gelbaugh	ゲルボー
Gemara	ゲマラ
Gene	ジーン
Geno	ジーノ
Genord	ジェノルド
Geoff	ジェフ
Geoff	ジョフ
George	ジョージ
Geovany	ジオバニー
Gerado	ジェラード
Gerald	ジェラルド
Gerard	ジェラルド
Germaine	ジャメイン
German	ヘルマン
Gerome	ジェロウム
Gerran	ジェラン
Gerrick	ゲアリック
Gerris	ゲリス
Gessner	ゲスナー
Getsy	ゲッツィ
Gettleman	ゲットルマン
Ghee	ギー
Ghent	グエン
Ghiaciuc	ジーアシウク
Gholston	ゴルストン
Giacomini	ジャコミニ
Giambi	ジアンビー
Giarratano	ジャラタノ
Gibbons	ギボンズ
Gibbs	ギブズ
Gibran	ギブラン
Gibril	ギブリル
Gibson	ギブソン
Giemont	ジーモント
Gifford	ギフォード
Gigantino	ギガンティノ
Gijon	ヒーホン
Gil	ギル
Gilbert	ギルバート
Gilbride	ギルブライド
Gilchrist	ギルクライスト
Gildon	ギルドン
Gill	ギル
Gilleo	ジレオ
Gillette	ジレット
Gilliam	ギリアム
Gillman	ギルマン
Gilmore	ギルモア
Gimenez	ヒメネス
Ginn	ギン
Gino	ジノ
Giordano	ジョルダーノ
Givens	ギヴンズ
Glasper	グラスパー
Glass	グラス
Glavine	グラヴィン
Glazer	グレイザー
Gleason	グリーソン
Glen	グレン
Glenn	グレン
Gload	グロード
Gloster	グロスター
Glover	グラヴァー
Glover	グローバー
Glymph	グリンフ
Glyn	グリン
Gobble	ゴッブル
Gocong	ゴーコン
Goda	ゴウダ
Godchaux	ゴッドチョー
Goddard	ゴダード
Godfrey	ゴドフリー
Godinez	ゴディネス
Goff	ゴフ
Goings	ゴーイングス
Gold	ゴールド
Goldberg	ゴールドバーグ
Golden	ゴールデン
Goldsberry	ゴールズベリー
Goldson	ゴールドソン
Golliday	ゴリデー
Golston	ゴルストン
Gomes	ゴメス
Gomez	ゴメス
Gonzalez	ゴンザレス
Gooch	グーチ
Goode	グード
Goodell	グッデル
Goodman	グッドマン
Goodrich	グッドリッチ
Goodson	グッドソン
Goodspeed	グッドスピード
Goodwell	グッドウェル
Goodwin	グッドウィン
Goolsby	グールズビー
Gorbal	ゴーバル
Gordon	ゴードン
Gore	ゴア
Gorin	ゴーリン
Gorneault	ゴーノールト
Gorzelanny	ゴーゼラニー
Gosder	ゴスダー
Gosling	ゴスリング
Gostkowski	ゴストウスキー
Gotay	ゴーテイ
Gould	ゴウルド
Gouveia	ゴウヴェイア
Gowin	ゴーウィン
Graber	グレイバー
Grabow	グラボウ
Grace	グレイス
Gradishar	グレイディシャー
Gradkowski	グラドカウスキー
Grady	グレイディ
Graessle	グレッシル
Graffanino	グラファニーノ
Gragg	グラッグ
Graham	グレアム
Gramatica	グラマティカ
Granderson	グランダーソン
Grange	グランジ
Grant	グラント
Grasmanis	グラスマニス
Graves	グレイヴス
Gray	グレイ
Grayling	グレイリング
Grayson	グレイソン
Grbac	ガーバック
Green	グリーン
Greene	グリーン
Green-Ellis	グリーンエリス
Greengross	グリーングロス
Greenway	グリーンウェイ
Greenwood	グリーンウッド
Greer	グリアー
Greg	グレッグ
Gregg	グレグ
Gregg	グレッグ
Gregory	グレゴリー
Greinke	グレインキー
Greisen	グライセン
Grennan	グレナン
Grey	グレイ
Griese	グリーシー
Griffeth	グリフィス
Griffey	ジュニア
Griffin	グリフィン
Griffith	グリフィス
Grigsby	グリグズビー
Grilli	グリッリ
Grimes	グライムズ
Grimm	グリム
Groce	グロース
Grogan	グローガン
Groh	グロー
Gronkowski	グロンコウスキー
Groom	グルーム
Groomes	グルームス
Grootegoed	グルートゴード
Gross	グロス
Grossman	グロスマン
Grot	グロット
Grove	グローヴ
Groves	グローブス
Groy	グロイ
Groza	グローザ
Grubbs	グラブス
Grubman	グラブマン
Gruden	グルーデン
Grudzielanek	グラジラーネク
Grunhard	グランハード
Guardado	ガダード
Guardia	グアルディア
Guenther	ギュンサー
Guerrero	ゲレロ
Guerrier	ゲリアー
Guidugli	グドゥーリー
Guillen	ギーエン
Guillermo	ギレルモ
Guillory	ギロリー
Gulley	ガリー
Guman	グーマン
Gundy	ガンディ
Gunn	ガン
Gunsel	ガンセル
Gunther	ガンサー
Gurode	グーロード
Gus	ガス
Guss	ガス
Gustavo	グスターヴォ
Gustavo	グスタボ
Gutekunst	グーテクンスト
Guthrie	ガスリー
Gutierrez	グティエレス
Guy	ガイ
Guyton	ガイトン
Guzman	グースマン
Guzman	グスマン
Gwacham	グワチャム
Gwynn	グウィン
H.B.	H.B.
Haack	ハーク
Haayer	ハーヤー
Hackenberg	ハッケンバーグ
Hackett	ハケット
Hackney	ハクニー
Haddad	ハダッド
Hadhazy	ハダージー
Hadl	ハドル
Hadley	ハドリー
Hadnot	ハドノット
Hafner	ハフナー
Hagan	ヘイガン
Hagans	ヘイガンズ
Hagel	ヘイゲル
Hagemann	ハーゲマン
Haggan	ハガン
Haggans	ハガンズ
Haggerty	ハガーティ
Haggins	ハギンズ
Hagiyama	ハギヤマ
Hagler	ハグラー
Hairston	ヘアストン
Hakeem	アキーム
Hakim	ハキーム
Hal	ハル
Halas	ハラス
Haley	ヘイリー
Hali	ハーリー
Hall	ホール
Halladay	ハラデー
Hallen	ホーレン
Haloti	ハロティー
Halterman	ハルタマン
Ham	ハム
Hambrick	ハンブリック
Hamby	ハンビー
Hamdan	ハムダン
Hameister-Ries	ハミズターリース
Hamels	ハメルズ
Hamilton	ハミルトン
Hamilton,	ハミルトン
Hamlett	ハムレット
Hamlin	ハムリン
Hamm	ハム
Hammel	ハメル
Hammoud	ハムード
Hampton	ハンプトン
Hamza	ハムザ
Hanburger	ハンバーガー
Hancock	ハンコック
Hand	ハンド
Hangartner	ハンガートナー
Hanie	ヘイニー
Hanigan	ハニガン
Hanik	ハニック
Hank	ハンク
Hanks	ハンクス
Hankton	ハンクトン
Hanley	ヘインリー
Hanley	ヘンリー
Hanlon	ハンロン
Hannah	ハンナ
Hannahan	ハンナハン
Hannam	ハナム
Hanneman	ハンネマン
Hannibal	ハンニバル
Hannon	ハノン
Hanoian	ハノイアン
Hanrahan	ハンラハン
Hansen	ハンセン
Hanson	ハンソン
Hape	ヘイプ
Haralson	ハラルソン
Harang	ハラング
Harbaugh	ハーボー
Harden	ハーデン
Hardiman	ハーディマン
Hardison	ハーディソン
Hardmon	ハードモン
Hardwick	ハードウィック
Hardy	ハーディ
Hare	ヘア
Haren	ヘイレン
Hargrave	ハーグレイヴ
Hargrove	ハーグローヴ
Harlan	ハーラン
Harland	ハーランド
Harley	ハーリー
Harline	ハーライン
Harlow	ハーロー
Harmon	ハーモン
Harold	ハロルド
Harper	ハーパー
Harrell	ハレル
Harrington	ハリントン
Harriott	ハリオット
Harris	ハリス
Harrison	ハリソン
Harry	ハリー
Hart	ハート
Hartigan	ハーティガン
Hartings	ハーティングズ
Hartley	ハートリー
Hartline	ハートライン
Hartmann	ハルトマン
Harts	ハーツ
Hartsock	ハートソック
Hartwell	ハートウェル
Hartwig	ハートウィグ
Haruki	ハルキ
Harvey	ハーヴェイ
Harvey	ハーベイ
Harvin	ハービン
Hasegawa	ハセガワ
Haskell	ハスケル
Haskins	ハスキンズ
Haslett	ハズレット
Hass	ハス
Hasselbeck	ハセルベック
Hatcher	ハッチャー
Hatchett	ハチェット
Hatteberg	ハッテバーグ
Hauschka	ハウシュカ
Havner	ヘイヴナー
Haw	ホウ
Hawk	ホーク
Hawkins	ホーキンス
Hawkins	ホーキンズ
Hawthorne	ホーソーン
Hawthrone	ホースロウン
Hayden	ヘイデン
Hayden	ヘイドン
Haye	ヘイ
Hayes	ヘイズ
Haynes	ヘインズ
Haynesworth	ハインズワース
Haynos	ヘイノス
Hayward	ヘイワード
Haywood	ヘイウッド
Hazelton	ヘイゼルトン
Heap	ヒープ
Heard	ハード
Hearst	ハースト
Heath	ヒース
Heck	ヘック
Heckert	ヘッカート
Hector	ヘクター
Hedgecock	ヘジコック
Heiden	ハイデン
Heilman	ハイルマン
Heimerdinger	ハイマーディンガー
Heinrich	ハインリック
Heintz	ハインツ
Heinz	ハインツ
Heitmann	ヘイトマン
Heller	ヘラー
Helms	ヘルムズ
Helu	ヘル
Henderson	ヘンダーソン
Hendricks	ヘンドリクス
Hendrickson	ヘンドリクソン
Heneghan	ヘネガン
Henne	ヘニー
Hennessy	ヘネシー
Henning	ヘニング
Henri	アンリ
Henry	ヘンリー
Henshaw	ヘンショー
Henson	ヘンソン
Hentrich	ヘントリック
Herana-Daze	ヘラナデイズ
Herb	ハーブ
Herbert	ハーバート
Herian	ヘリアン
Herman	ハーマン
Hermida	ハーミダ
Hernandez	ヘルナンデス
Herndon	ハーンドン
Herold	エイロウルド
Herrell	ヘレル
Herremans	ヘリマンズ
Herrera	ヘレーラ
Herrera	ヘレラ
Herring	ヘリング
Herrion	ヘリオン
Herrmann	ヘルマン
Herron	ヘロン
Herschel	ハーシェル
Herzing	ヘルツィグ
Hessman	クレブレン
Hester	ヘスター
Hetherington	ヘザリントン
Heuer	ホイヤー
Heyer	ヘヤー
Heyward	ヘイワード
Heyward-Bey	ヘイワードベイ
Hickerson	ヒッカーソン
Hickey	ヒッキー
Hickman	ヒックマン
Hickok	ヒコック
Hicks	ヒックス
Hiestand	ヒースタンド
Higgins	ヒギンズ
Highsmith	ハイスミス
Hightower	ハイタワー
Hilee	ヒリー
Hilgenberg	ヒルゲンバーグ
Hill	ヒル
Hillenmeyer	ヒレンマイヤー
Hilliard	ヒリアード
Hilton	ヒルトン
Hines	ハインズ
Hinkel	ヒンケル
Hinkle	ヒンクル
Hinske	ヒンスキー
Hinton	ヒントン
Hippler	ヒップラー
Hiram	ハイラム
Hirsch	ハーシュ
Hittner	ヒットナー
Hixon	ヒクソン
Hoag	ホーグ
Hoak	ホーク
Hoambrecker	ホームブレッカー
Hobbs	ホブズ
Hobby	ホビー
Hobson	ホブソン
Hochevar	ホッシェバー
Hochstein	ホクスタイン
Hodel	ホデル
Hodgdon	ホジドン
Hodge	ホッジ
Hodges	ホッジズ
Hodgins	ホジンズ
Hoeppner	ヘプナー
Hoey	ホーイ
Hoffman	ホフマン
Hoffmann	ホフマン
Hoke	ホウク
Holcomb	ホルコム
Holcombe	ホルコム
Holdman	ホールドマン
Holiday	ホリデー
Holland	ホーランド
Hollenbach	ホーランボック
Hollenbeck	ホレンバック
Holley	ホリー
Holliday	ホリデイ
Holliday	ホリデー
Hollier	オリーエイ
Hollings	ホリングズ
Hollis	ホリス
Holloway	ホロウェイ
Hollowell	ホロウェル
Holly	ホリー
Holmberg	ホームバーグ
Holmes	ホームズ
Holmgren	ホルムグレン
Holt	ホルト
Holtz	ホルツ
Homer	ホーマー
Hood	フッド
Hooper	フーパー
Hoover	フーヴァー
Hoover	フーバー
Hope	ホウプ
Hopkins	ホプキンズ
Hopoi	ホポイ
Hopper	ホッパー
Hopson	ホプソン
Horacio	ホレシオ
Horan	ホーラン
Hori	ホリ
Horn	ホーン
Horne	ホーン
Hornung	ホーナング
Horton	ホートン
Horvath	ホルヴァート
Hosack	ホサック
Hostler	ホスラー
Houchin	ハウチン
Houck	ホウク
House	ハウス
Houser	ハウザー
Houshmandzadeh	フーシュマンザーデ
Houston	ヒューストン
Hovan	ホーヴァン
Howard	ハワード
Howell	ハウェル
Howell	ハウエル
Howfield	ハウフィールド
Howie	ハウィ
Howie	ハウイ
Howry	ハウリー
Howton	ホートン
Hoyte	ホイト
Huard	ファード
Hubbard	ハバード
Huber	フーバー
Huckeba	ハッカビー
Hudson	ハドソン
Hue	ヒュー
Huey	ヒューイ
Huff	ハフ
Huffman	ハフマン
Hufnagel	ハフネイゲル
Huggins	ハギンズ
Hugh	ヒュー
Hughes	ヒューズ
Hughley	ヒューリー
Hugo	ヒューゴ
Huizenga	ハイゼンガ
Hull	ハル
Hulsey	ハルジー
Humber	ヒューバー
Humberto	ハンベルト
Humes	ヒュームズ
Humphrey	ハンフリー
Humphries	ハンフリーズ
Hunley	ハンリー
Hunt	ハント
Hunter	ハンター
Huntley	ハントリー
Hupsel	ハプセル
Hurd	ハード
Hurley	ハーリー
Hurney	ハーニー
Hurtado	ウルタード
Hussey	ハッシー
Husted	ヒューステッド
Huston	ヒューストン
Hutchins	ハッチンズ
Hutchinson	ハッチンソン
Hutson	ハットソン
Hutton	ハットン
Huyghue	ヘウグー
Hybl	ハイブル
Hyde	ハイド
Hymes	ヘイムズ
Ian	イアン
Ibanez	イバネス
Ibekwe	イーベックウェイ
Ichiro	イチロー、イチロー
Idonije	アイドニージェ
Idrees	イドリーズ
Ifeanyi	イフィアーニ
Ifedi	アイフェディ
Igawa	イガワ
Igor	イゴール
Iguchi	イグチ
Ihedigbo	イへディボー
Iiro	イーロ
Ijalana	イジャラナ
Ijames	イメス
IK	イケメファナ
Ikaika	イーカイカ
Ike	アイク
Ilaoa	イーロウワ
Incognito	インコグニト
Infante	インファンテ
Inge	イング
Ingle	イングル
Inglett	イングレット
Ingram	イングラム
Inman	インマン
Ioane	イオーニ
Iorio	アイオリオ
Ira	アイラ
Irons	アイアンズ
Irsay	アーゼイ
Irv	アーヴ
Irvin	アーヴィン
Irving	アーヴィング
Isaac	アイザック
Isai	イザイ
Isaiah	アイゼイア
Ishida	イシダ
Ishmael	イシュマエル
Ishola	イショラ
Ismail	イスマイル
Israel	イズレイエル
Itula	イトゥーラ
Ivan	イバン
Ivanov	イワノフ
Ivory	アイボリー
Ivy	アイヴィー
Iwuchukwu	ウウィッチウクー
Iwuh	イウー
Iwuoma	イウォウマ
Izturis	イズタリス
Izzo	イッゾ
J.B.	J.B.
J.C.	J.C.
J.D.	J.D.
J.J.	J.J
J.J.	J.J.
J.P.	J.P.
J.R.	J.R.
J.R.	フンベルト
J.T.	J.T.
Jabar	ジャバー
Jabari	ジャバリ
Jacas	ジャッカス
Jace	ジェイス
Jack	ジャック
Jackie	ジャッキー
JackKent	ジャックケント
Jackson	ジャクソン
Jacob	ジェイコブ
Jacobs	ジェイコブス
Jacobs	ジェイコブズ
Jacoby	ジャコービー
Jacoby	ジャコビー
Jacox	ジェイコックス
Jacque	ジャック
Jacques	ジャッケズ
Jacquian	ジャクワン
Jagodzinski	ジャゴジンスキー
Jahmile	ジャモール
Jahnke	ヤンケ
Jahnkeen	ヤーンキーン
Jahri	ジリー
Jahvid	ジャービー
Jai	ジェイ
Jaiquawn	ジェイクワン
Jair	ジェアー
Jairus	ジェイラス
Jakari	ジャカリ
Jake	ジェイク
Jakeem	ジャキーム
Jalen	ジェイレン
Jalin	ジャーリン
Jamaal	ジャーマル
Jamaal	ジャマール
Jamaar	ジャマー
Jamacia	ジャマシア
Jamaica	ジャマイカ
Jamaine	ジャメイン
Jamal	ジャマール
Jamall	ジャマール
Jamar	ジャマー
JaMarcus	ジャマーカス
Jameel	ジャミール
Jamel	ジャメール
James	ジェイムズ
James	ジェームズ
Jameson	ジェイムソン
Jamey	ジェーミー
Jami	ジャミー
Jamie	ジェイミー
Jamin	ジャミン
Jamir	ジャミール
Jamison	ジャミソン
Jammal	ジャモール
Jammer	ジャマー
Jamon	ジェイモン
Jan	ジャン
Jan	ヤン
Janikowski	ジャニカウスキー
Jansen	ジャンセン
Janssen	ジャンセン
January	ジャニュアリー
Jared	ジャレッド
Jaret	ジャレット
Jarett	ジャレット
Jarious	ジャリアス
Jarmo	ヤルモ
Jarrad	ジャレッド
Jarrell	ジャレル
Jarret	ジャレット
Jarrett	ジャレット
Jarrod	ジェレッド
Jarrod	ジャロッド
Jarvis	ジャーヴィス
Jasen	ジェイセン
Jashon	ジャショーン
Jasmin	ジャスマン
Jason	ジェイソン
Jason	ジェーソン
Jasper	ジャスパー
Jauron	ジャローン
Javarus	ジャヴァラス
Javiar	ジャヴィアー
Javier	ハビアー
Javier	ハビエル
Javin	ジャヴィン
Javon	ジェボン
Javon	ジャヴォン
Javor	ジェイヴァー
Ja'Warren	ジャウォーレン
Jaworski	ジャワースキ
Ja'Wuan	ジャワン
Jaxson	ジャクソン
Jay	ジェイ
Jayme	ジェイミー
Jayson	ジェイソン
Jayson	ジェーソン
Jean	ジーン
Jean-Gilles	ジーンギリス
Jeanty	ジーンティ
Jeb	ジェブ
Jed	ジェド
Jeff	カンバーランド
Jeff	ジェフ
Jeffers	ジェファーズ
Jefferson	ジェファーソン
Jeffery	ジェフリー
Jeffrey	ジェフリー
Jehu	ジェフ
Jemalle	ジャモール
Jemelle	ジャメル
Jemison	ジェミソン
Jenkins	ジェンキンス
Jenkins	ジェンキンズ
Jenks	ジェンクス
Jennings	ジェニングス
Jennings	ジェニングズ
Jeno	ジェノ
Jensen	ジェンセン
Jensen	ジャンセン
Jerald	ジェラルド
Jerame	ジェラミー
Jerametrius	ジェラメトリアス
Jerard	ジェラード
Jered	ジェレッド
Jerel	ジェレル
Jeremaine	ジェレメイン
Jereme	ジェレミー
Jeremi	ジェレミー
Jeremiah	ジェレマイア
Jeremy	ジェレミー
Jerheme	ジェレミー
Jerious	ジェリオス
Jeris	ジェリス
Jermaine	ジャーメイン
Jermaine	ジャメイン
Jerman	ジャーマン
Jermane	ジャメイン
Jermial	ジャーミアル
Jermichael	ジャーマイケル
Jermon	ジャーモン
Jerod	ジェロッド
Jerome	ジェローム
Jeromey	ジェロミー
Jerramy	ジャラミー
Jerrell	ジャレル
Jerricho	ジェリコ
Jerrold	ジェロルド
Jerron	ジェロン
Jerry	ジェリー
Jesse	ジェシー
Jessie	ジェシー
Jesus	ヘスス
Jeter	ジーター
Jethro	ジェスロ
Jevon	ジェヴォン
Jhonny	ジョニー
Jim	ジム
Jimenez	ヒメネス
Jimerson	ジマーソン
Jimmy	ジミー
Jimoh	ジモー
Joachim	ヨアキム
Joakim	ホアキム
Joaquin	ホアキン
Joba	ジョバ
Jody	ジョディ
Joe	ジョー
Joel	ジョエル
Joey	ジョーイ
Johan	ヨハン
John	ジョン
Johnathan	ジョナサン
Johnathanio	ジョナサニオ
JohnDavid	ジョンデイヴィッド
John-Ford	ジョン
Johnnie	ジョニー
Johnnie	ジョニーリー
Johnny	ジョニー
JohnPaul	ジョンポール
Johnson	ジョンソン
Johnston	ジョンストン
Johnstone	ジョンストン
Joiner	ジョイナー
JoJo	ジョジョ
Jo-Jo	ジョジョ
Jolley	ジョリー
Jolly	ジョリー
Jo-Lonn	ジョーロン
Jon	ジョン
Jonah	ジョナー
Jonas	ジョーナス
Jonathan	ジョナサン
Jones	ジョーンズ
Jones-Drew	ジョーンズ ドリュー
Jonny	ジョニー
Jonotthan	ジョナサン
Jonta'	ジョンテイ
Joppru	ジョプル
Jordan	ジョーダン
Jordy	ジョーディー
Jorge	ショーン
Jorge	ホルゲ
Jorge	ホルヘ
Jorvorskie	ジョボスキー
Jose	ホセ
Jose	ホゼ
Joselio	ホセリオ
Joseph	ジョセフ
Josh	ジョシュ
Joshua	ジョシュア
Jovan	ホアン
Jovon	ジョヴォン
Joyce	ジョイス
Juan	ジュアン
Juan	フアン
Juan	ホワン
JuanManuel	ファンマヌエル
Judd	ジャッド
Jue	ジュー
Julian	ジュリアン
Julio	フリオ
Julius	ジュリアス
June	ジューン
Junior	ジュニア
Junius	ジュニアス
Juqua	ジャキュア
Juran	ジュラン
Jurevicius	ジャーヴィシャス
Jurgen	ユルゲン
Jurgensen	ジャーゲンセン
Jurrjens	ユーリエンス
Justice	ジャスティス
Justin	ジャスティン
Justise	ジャスティス
Juston	ジャストン
Juwan	ジュワン
J'Vonne	ジェイヴォン
Jyles	ジャイルズ
K.S.	K.S.
Kabeer	カビーア
Kacyvenski	カシヴェンスキー
Kaczur	ケイザー
Kadela	カデーラ
Kader	カデール
Kaeding	キーディング
Kaepernick	ケイパニック
Kaesviharn	ケイスヴィハーン
Kahlil	カリール
Kahui	カフイ
Kai	カイ
Kailee	カイリー
Kaiser	カイザー
Kaleita	カレータ
Kalen	カレン
Kalif	カリフ
Kalil	カリル
Kalimba	カリンバ
Kallfelz	カルフェルツ
Kalsu	カルスー
Kalu	カル
Kalvin	カルヴィン
Kam	カム
Kamerion	カメリオン
Kameron	カメロン
KaMichael	ケイマイケル
Kampman	キャンプマン
Kanavis	カナヴィス
Kantroy	カントロイ
Kareem	カリーム
Karibi	カレービー
Karim	カリム
Karl	カール
Karlos	カルロス
Karney	カーニー
Karon	ケイロン
Kasay	ケイシー
Kasey	ケイシー
Kashama	カシャーマ
Kashetta	カシェッタ
Kason	ケーソン
Kasper	キャスパー
Kassell	カセール
Kassim	カシム
Kathrin	カトリーン
Katnik	カットニク
Kato	カトウ
Katula	カトゥーラ
Katz	カッツ
Katzenmoyer	カッツェンモイヤー
Kavanaugh	カヴァナフ
Kawika	カウィーカ
Kay	ケイ
Kay-Jay	ケイジェイ
Kays	ケイズ
Kazee	カジー
Kazmir	キャズミアー
Keanu	キアヌ
Kearney	カーニー
Kearns	カーンズ
Kearse	カース
Keary	キアリー
Keasey	カーズィー
Kedric	ケードリック
Keele	キール
Keeler	キーラー
Keels	キールズ
Keenan	キーナン
Keenist	キーニスト
Keeton	キートン
Keglar	ケグラー
Kei	ケイ
Keiaho	キーアホー
Keion	キーオン
Keisel	カイゼル
Keith	キース
Keiwan	ケイワン
Kelce	ケルシー
Kellen	ケレン
Keller	ケラー
Kellett	ケレット
Kelley	ケリー
Kelly	ケリー
Kelsay	ケルゼイ
Kelsch	ケルシュ
Kelvim	ケルビン
Kelvin	ケルヴィン
Kelvin	ケルビン
Kemal	ケマル
Kemoeatu	ケモウトゥ
Kemp	ケンプ
Ken	ケン
Ken	ケングリフィ
Kenard	ケナード
Kenbrell	ケンブレル
Kendall	ケンドール
Kenderick	ケンデリック
Kendrell	ケンドレル
Kendrick	ケンドリック
Kendry	ケンドリー
Kendyl	ケンディル
Kendyll	ケンダイル
Kenechi	ケニーチ
Kenn	ケン
Kennan	ケナン
Kennard	ケナード
Kennedy	ケネディ
Kenneth	ケネス
Kennison	ケニソン
Kenny	ケニー
Kenoy	キノイ
Kenrick	ケンリック
Kensing	ケンシング
Kent	ケント
Kentaro	ケンタロウ
Kenton	ケントン
Kenwin	ケンウィン
Kenyan	ケニア
Kenyatta	ケニヤッタ
Kenyon	ケニオン
Keon	キーオン
Keppinger	ケッピンガー
Kerley	カーリー
Kern	カーン
Kerney	カーニー
Keron	ケイロン
Kerry	ケリー
Kershaw	カーショー
Kesic	ケシック
Kevan	キーヴァン
Kevin	ケヴィン
Kevin	ケビン
Kevis	ケヴィス
Keyaron	キーアーロン
Keydrick	キードリック
Keylon	キーロン
Keyon	キーオン
Keyonta	キオンタ
Keys	キーズ
Keyshawn	キーショーン
Keyunta	キーウンテイ
Khaleed	カリード
Khalid	カリード
Khalif	カーリフ
Khari	カーリー
Khary	カーリィ
Khiry	カイリー
Khreem	クリーム
Kieft	キーフト
Kiel	キール
Kielty	キルティ
Kiffin	キフィン
Kight	カイト
Kiick	キーック
Kiko	キコ
Kili	キーリー
Kilian	キリアン
Killeen	キレーン
Killings	キリングズ
Killion	キリオン
Kilmer	キルマー
Kilroy	キルロイ
Kim	キム
Kimball	キンボール
Kimble	キンブル
Kimo	キーモ
Kimrin	キムリン
Kincade	キンケイド
Kindal	キンドール
Kindle	キンドル
King	キング
Kingsbury	キングズバリー
Kinney	キニー
Kinoshita	キノシタ
Kinsler	キンスラー
Kipahti	キパーティ
Kipp	キップ
Kippy	キッピー
Kirby	カービー
Kircus	カーカス
Kirk	カーク
Kirkland	カークランド
Kirksey	カークシー
Kirsch	キルシュ
Kirschke	カーシュキー
Kirtman	カートマン
Kitchens	キッチンズ
Kitna	キトナ
Kittner	キットナー
Kiwanuka	キーワヌーク
Kiwaukee	キウォーキー
Klatt	クラット
Klaus	クラウス
Klecko	クレッコ
Kleinsasser	クラインソウサー
Klemm	クレム
Kliff	クリフ
Klopfenstein	クロプフェンスタイン
Kluwe	クラウ
Knafelc	ナフェルク
Knapp	ナップ
Knight	ナイト
Knighton	ニュートン
Knorr	ノーア
Knott	ノット
Knowshon	ノーション
Knox	ノックス
Ko	コー
Koa	コーア
Kobel	コーベル
Koch	クック
Kody	コウディ
Koehl	コウル
Koenen	ケイネン
Koets	コーツ
Koetter	カッター
Koki	コウキ
Kolb	コッブ
Kolby	コルビー
Kollar	コラー
Kolodziej	コロージエイ
Konerko	コナーコ
Konrad	コナード
Kony	コニー
Konz	コンツ
Kooistra	クーイストラ
Koonce	クーンス
Koppen	コッペン
Koral	コラル
Kordell	コーデル
Koren	コーレン
Korey	コーリー
Kori	コウリー
Korrodi	コロディ
Kory	コーリー
Kosar	コーザー
Kosier	コウジャー
Koskie	コスキー
Kotchman	コッチマン
Kotsay	コッツェー
Koutouvides	コウトウヴァイズ
Kowalewski	コヴァレフスキー
Kowalkowski	コワルカウスキー
Koy	コイ
Kozlowski	コズラウスキー
Kpassagnon	パセニオ
Kracalik	クラカリック
Kraft	クラフト
Kragthorpe	クラグソープ
Krakoski	クラコスキー
Kramer	クレイマー
Kranchick	クランチック
Krause	クラウス
Kreider	クライダー
Krenzel	クレンゼル
Kreutz	クルーツ
Krichavsky	クリチャヴスキー
Krieg	クリーグ
Kriewaldt	クリーウォルド
Kris	クリス
Kristen	クリステン
Kropog	クロポグ
Kroul	クロウル
Kruczek	クルーゼク
Krug	クルーグ
Krumrie	クラムリー
Kuale	クワリー
Kubel	クベル
Kubiak	クービアック
Kubin	クービン
Kudla	クードラ
Kuechenberg	キューチェンバーグ
Kuehl	クーエル
Kuharchek	クハーチェク
Kuhn	クーン
Kuliga	クリガ
Kuper	クーパー
Kupp	クップ
Kuresa	クレース
Kurpeikis	カーペイキス
Kurt	カート
Kwaku	クワックー
Kwame	クワミ
Kwan	クワン
Kyle	カイル
Kynan	カイナン
L.C.	L.C.
L.J.	L.J.
L.P.	L.P.
Labinjo	ラビインヨ
LaBoy	ラボーイ
LaBrandon	ラブランドン
Lac	ラック
Lacasse	ラカス
Lacey	レイシー
LaChapelle	ラシャペル
Lackey	ラッキー
Lacy	レイシー
LaDainian	ラデイニアン
LaDaris	ラダリス
Ladd	ラッド
Ladell	ラデール
Ladouceur	ラドウサー
Lafayette	ラファイエット
Laffey	ラフィー
Laird	レアード
LaJuan	ラジュアン
Lake	レイク
Lal	ラル
Lamar	ラマー
LaMarcus	ラマーカス
LaMarr	ラマー
Lamart	ラマート
Lamb	ラム
Lambert	ランバート
Lamin	ラミン
Lamkin	ラムキン
Lamont	ラモント
LaMonte	ラモント
Lampkin	ランプキン
Lancaster	ランカスター
Lance	ランス
Landeta	ランデータ
Landolt	ランドルト
Landon	ランドン
Landri	ランドリ
Landrom	ランドロム
Landry	ランドリー
Lane	レイン
Lane	レーン
Lang	ラング
Langer	ランガー
Langerhans	ランガーハンス
Langford	ラングフォード
Langston	ラングストン
Lanier	ラニアー
Lankster	ランクスター
Lano	ラーノ
Lantz	ランツ
Lardarius	ラダーリス
Laremy	ラレミー
Largent	ラージェント
LaRoche	ラローシュ
La'Roi	ラロイ
LaRon	ラロン
LaRon	ルロン
Laroni	ラロニ
LaRoy	ラロワ
Larry	ラリー
Larsen	ラーセン
Larson	ラーソン
LaRue	ラルー
LaShaun	ラショーン
Laskowski	ラスカウスキー
Lastings	ラスティング
LaTendresse	ラテンドレス
Latimer	ラティマー
Latka	ラトカ
Latsko	ラツコ
Lau	ラウ
Lauren	ローレン
Laurence	ローレンス
Laurent	ローラン
Laurent	ローレント
Laurinaitis	ローリナイティス
Laury	ローリー
Lauvale	ロヴェイル
Lauzon	ローゾン
Lavalais	ラヴァライズ
LaVar	ラヴァー
Lavelle	ラベル
Lavelli	ラヴェーリ
Laveranues	ラヴェラニアス
Law	ロー
LaWaylon	ラウェイロン
Lawrence	ローレンス
Lawrie	ロウリー
Lawson	ローソン
Lawton	ロートン
Lawyer	ロイヤー
Lay	レイ
Layden	レイデン
Laynce	レインス
Layne	レイン
Leach	リーチ
Leaders	リーダーズ
Leaf	リーフ
League	リーグ
Leak	リーク
Leake	リーク
Leander	リアンダー
Leavy	リーヴィ
LeBeau	ルボウ
Leber	リーバー
LeBlanc	ルブラン
LeCharles	レチャールズ
Lechler	レクラー
Leckey	レッキー
LeCroy	リクロイ
Ledford	レッドフォード
Lee	リー
Leeson	リーソン
Leffew	レフュー
LeFors	ラフォーズ
Lefotu	レフォトゥ
Leftwich	レフトウィッチ
Legedu	レジェドゥ
Leger	リージャー
Leger	レジャー
Leggett	レゲット
Legree	レグリー
Lehan	リーハン
Lehman	リーマン
Lehr	レアー
Leibkind	ライプキント
Leicester	レスター
Leigh	リー
Leinart	ライナート
Leisle	レイスル
Leitko	ライトコ
Leiweke	ライウィッキー
LeJeune	レジューン
LeKevin	ラケヴィン
Lekkerkerker	レッカーカーカー
Lelie	レリー
Lem	レム
Lemanski	レマンスキー
Lemar	レマー
Lemon	レモン
Lemonier	ルモニエ
Len	レン
Lenda	レンダ
LenDale	レンデル
Lennie	レニー
Lenny	レニー
Lenon	レノン
Lentz	レンツ
Leo	レオ
Leon	レオン
Leonard	レオナード
Leonard	レナード
Leonardo	リオナード
Leone	レオーネ
Leonhard	レナード
Leonte	レオンテ
Lepsis	ラプシス
Lerner	レイナー
LeRon	リロン
Le'Ron	レロン
LeRoy	ラロイ
Leroy	リロイ
Les	レス
LeSean	ルショーン
Leshnock	レシュノック
Leslie	レズリー
Lester	レスター
LeSueur	レスーア
LeVar	レヴァー
Levens	レヴェンズ
Leverette	レヴァレット
Levey	リーヴィ
Levi	リーヴァイ
Levine	レヴァイン
Levitre	レビツリー
LeVoir	ルヴォワール
Levon	リーヴォン
LeVonne	レヴォンヌ
Levy	リーヴィ
Lew	ルー
Lewand	ルウォンド
Lewandowski	ルワンドウスキー
Lewis	ルイス
Lex	レックス
Leyva	レイヴァ
Li	リー
Liam	リーアム
Licht	リヒト
Lidge	リッジ
Lieber	リーバー
Liess	リース
Ligashesky	リガシェスキー
Light	ライト
Lightbody	ライトボディ
Lilja	リルヤ
Lilly	リリー
Lincoln	リンカーン
Lind	リンド
Lindell	リンデル
Linden	リンデン
Lindsay	リンゼイ
Lindsey	リンジー
Lindstrom	リンドストロム
Linebrink	ラインブリンク
Linehan	リネハン
Lingor	リンゴー
Lin-J	リン－Ｊ
Linson	リンソン
Linta	リンタ
Linza	リンツァ
Lional	ライオナル
Lionel	ライオネル
Lippett	リペット
Lira	リラ
Liriano	リリアーノ
Lisa	リサ
Lito	リト
Litsch	リッチ
Little	リトル
Littlejohn	リトルジョン
Littleton	リトルトン
Livings	リヴィングズ
Livingston	リビングストン
Liwienski	リウィンスキー
Liz	リズ
Lloyd	ロイド
Lobdell	ロブデル
Lockett	ロケット
Lockette	ロケット
Lockhart	ロックハート
Locklear	ロックリア
LoDuca	ロデューカ
Loe	ロー
Loeffler	ローフラー
Lofa	ローファ
Lofton	ロフトン
Logan	ローガン
Lohse	ローシュ
Lois	ロイス
Lomax	ローマクス
Lombardi	ロンバルディ
London	ロンドン
Londot	ロンドット
Loney	ロニー
Long	ロン
Long	ロング
Longley	ロングリー
Longwell	ロングウェル
Lonie	ロニー
Lonta	ロンタ
Lonzell	ロンゼール
Looker	ルッカー
Loomis	ルーミス
Loper	ロウパー
Lopez	ロペス
Lord	ロード
Loredo	ロレド
Lorello	ロレロ
Loren	ローレン
Lorenzen	ロレンゼン
Lorenzo	ロレンゾ
Loretta	ロレッタ
Lorn	ローン
Losman	ロスマン
Lothe	ロース
Lott	ロット
Lou	ルー
Lougheed	ロウヒード
Louis	ルイス
Lousaka	ルーサカ
Love	ラブ
Lovell	ラヴェル
Loverne	ラヴァーン
Lovie	ラヴィ
Lowber	ロウバー
Lowe	ロウ
Lowell	ローウェル
Lowery	ロウリー
Lowry	ロウリー
Loyd	ロイド
Lua	ルーウ
Lucarelli	ルカレッリ
Lucas	ルーカス
Luchey	ルシェイ
Lucier	ルーシアー
Luckman	ラックマン
Lucky	ラッキー
Lucy	ルーシー
Luginbill	ラギンビル
Lugo	ルーゴ
Luis	ルイス
Lujack	ルジャック
Luke	ルーク
Lulay	ルーレイ
Lumsden	ラムスデン
Luna	ルナ
Lundy	ランディ
Luoto	リュオット
Lurie	ルーリー
Luther	ルーサー
Lutui	ラトゥーイー
Luzar	ルーザー
Lydon	リドン
Lyle	ライル
Lyman	ライマン
Lynch	リンチ
Lynell	リンネル
Lynn	リン
Lynzell	リンゼール
Lyonel	ライオネル
Lyons	ライアンズ
Maake	マーキ
Mabry	メイブリー
Macay	マカイ
MacDonald	マクドナルド
MacDougal	マクドガル
MacDuff	マクダフ
Mace	メイス
Machado	マチャド
MacIntyre	マキンタイア
Mack	マック
Mack	マックリー
Mackenzie	マッケンジー
Mackenzy	マッケンジー
Mackey	マッキー
Mackler	マックラー
Macklin	マクリン
Maclin	マクリーン
MacNeil	マクニール
Madden	マッデン
Maddox	マドックス
Madieu	メデュー
Madison	マディソン
Madsen	マドセン
Madson	マドソン
Maese	ミーズ
Magazu	マガズー
Magglio	マグリオ
Magner	マグナー
Maguire	マグアイア
Mahan	メイハン
Mahay	マヘイ
Mahe	マーエイ
Mahelona	マーエロナ
Maholm	マホーム
Mahomes	マホームズ
Maicer	マイセル
Maine	メーン
Majewski	マジェウスキー
Majkowski	マジカウスキ
Majondo-Mwamba	マジョンドムワンバ
Major	メジャー
Makoa	マコア
Malano	マラーノ
Malcolm	マルコム
Malcom	マルコム
Maldonado	マルドナド
Mallard	マラード
Malm	マルム
Malone	マローン
Manaia	マナイア
Manase	マネイゼ
Manderino	マンデリーノ
Mandolesi	マンドレーズィ
Manfred	マンフレッド
Mangini	マンジーニ
Mangold	マンゴールド
Mangum	マンガム
Manin	マニン
Mankins	マンキンズ
Manley	マンリー
Mann	マン
Mannelly	マンリー
Manning	マニング
Manningham	マニンガム
Manny	マニー
Mansfield	マンスフィールド
Manuel	マニュエル
Manumaleuna	マヌマレウーナ
Manupuna	マヌプーナ
Manusky	マヌスキー
Manuwai	マヌワイ
Mara	マーラ
Marc	マーク
Marcedes	マーセデス
Marcel	マーセル
Marceline	マーセリン
Marcell	マーセル
Marcello	マルチェロ
Marcellus	マーセラス
Marchetti	マーチェティ
Marchibroda	マーチブローダ
Marciano	マルチアーノ
Marcin	マーチン
Marco	マーコ
Marco	マルコ
Marcos	マルコス
Marcum	マーカム
Marcus	マーカス
Mare	マーレイ
Margerum	マージェラム
Mariano	マリアーノ
Marinelli	マリネリ
Marino	マリーノ
Marinovich	マリノヴィッチ
Marinucci	マリヌッチ
Mario	マリオ
Marion	マリオン
Mariucci	マリウーチ
Mark	マーク
Markakis	マーカキス
Markbreit	マークブライト
Markee	マーキー
Marko	マーコ
Marks	マークス
Markus	マーカス
Marler	マーラー
Marlin	マーリン
Marlion	マーライオン
Marlon	マーロン
Marmol	マーモル
Maroney	マロニー
Marquand	マークァンド
Marquay	マークウェイ
MarQueis	マーキス
Marques	マーケス
Marquess	マーキス
Marquice	マーキス
Marquies	マーキーズ
Marquis	マーキース
Marquis	マーキス
Marquise	マーキーズ
Marrone	マローン
Marrow	マロウ
Marsh	マーシュ
Marshal	マーシャル
Marshall	マーシャル
Marshawn	マーショーン
Marte	マーテ
Marten	マーテン
Martin	マーティン
Martindale	マーティンデイル
Martinez	マルチネス
Martinez	マルティネス
Martino	マルティーノ
Martrez	マートレス
Marty	マーティ
Martz	マーツ
Marv	マーヴ
Marvel	マーヴェル
Marviel	マーヴィル
Marvin	マーヴィン
Masakazu	マサカズ
Maser	メイザー
Maslowski	マズラウスキー
Mason	メイソン
Massaquoi	マザクワ
Massey	マシー
Mastny	マストニー
MaSun	マスーン
Mat	マット
Mathias	マシアス
Mathieson	マシーソン
Mathis	マシス
Matla	マトラ
Matson	マットソン
Matt	マット
Matthew	マシュー
Matthew	マット
Matthews	マシューズ
Matthias	マシアス
Mattos	マトス
Matua	マトゥア
Matuszak	マツーザック
Maualuga	マウアルガ
Mauck	マック
Mauer	マウアー
Mauer	モウアー
Mauga	マウガ
Mauger	モージェ
Mauia	モーイーア
Mauldin	モールディン
Maurice	モーリス
Mauricio	マウリシオ
Mauro	マウロ
Mawae	マワイ
Max	マックス
Maxey	マクシー
Maxie	マクシー
Maxwell	マクスウェル
Maxwell	マックスウェル
Mayberry	メイベリー
Maybin	メイビン
Maye	メイ
Mayer	メイヤー
Mayers	メイヤーズ
Mayes	メイズ
Mayle	メイル
Maynard	メイナード
Mayo	メイヨ
Mayock	メイヨック
Mays	メイズ
Maze	メイズ
Mazzone	マッツォーネ
McAddley	マキャドリー
McAdoo	マカドゥー
McAfee	マカフィー
McAlister	マカリスター
McAllister	マカリスター
McAlmont	マカルモント
McBean	マクビーン
McBeth	マクベス
McBriar	マクブライアー
McBride	マクブライド
McBrien	マクブライエン
McCadam	マキャダム
McCafferty	マキャファーティ
McCaffrey	マキャフリー
McCain	マッケイン
McCann	マキャン
McCann	マッキャン
McCants	マキャンツ
McCardell	マカーデル
McCareins	マキャラインズ
McCargo	マッカーゴ
McCarthy	マッカーシー
McCartney	マッカートニー
McCarty	マッカーティ
McCaskey	マカスキー
McCauley	マッコーリー
McChesney	マクチェスニー
McClain	マクライン
McClellan	マクレラン
McClendon	マクレンドン
McCleon	マクレオン
McCleskey	マクレスキー
McCloughan	マクルーハン
McClover	マックローヴァー
McClung	マクラング
McClure	マクルア
McCollum	マッカラム
McCombs	マッコムズ
McConkey	マッコンキー
McCormack	マコーマック
McCourty	マッコーティ
McCown	マッカウン
McCoy	マッコイ
McCrary	マクレアリー
McCray	マックレイ
McCready	マクリーディ
McCree	マクリー
McCullough	マカロウ
McCullum	マッカラム
McCune	マキューン
McCutcheon	マクカッチェオン
McDaniel	マクダニエル
McDaniels	マクダニエルズ
McDermott	マクダーモット
McDonald	マクドナルド
McDougle	マクダグル
McElhenny	マッケレニー
McElroy	マッケルロイ
McElveen	マッケルヴィーン
McElwain	マッケルウェイン
McFadden	マクファデン
McFadin	マクファディン
McFarland	マクファーランド
McFoy	マックフォイ
McGahee	マクゲイヒー
McGann	マッギャン
McGarigle	マギャリグル
McGarrahan	マギャラハン
McGaughey	マゴーヒー
McGee	マギー
McGhee	マギー
McGhghy	マクゲイヒー
McGill	マギル
McGinest	マッギネスト
McGinley	マッギンリー
McGinnis	マクギニス
McGlockton	マグロックトン
McGlothlin	マグロスリン
McGowan	マゴウアン
McGowan	マゴワン
McGrath	マッグロウ
McGraw	マッグロウ
McGrew	マッグルー
McGrorty	マクグローティ
McGruder	マグルーダー
McGuire	マグワイア
McHugh	マクヒュー
McInally	マキナリー
McIntosh	マキントッシュ
McIntyre	マッキンタイア
McIvor	マカイヴァー
McKay	マッケイ
McKeever	マッキーヴァー
McKenzi	マッケンジー
McKenzie	マッケンジー
McKie	マキー
McKinley	マッキンリー
McKinney	マッキニー
McKinnie	マキニー
McKinnon	マキノン
McKnight	マクナイト
McKnight,	マクナイト
McLean	マクリーン
McLee	マクリー
McLemore	マクレモア
McLendon	マクレンドン
McLouth	マクロース
McMahan	マクマーン
McMahon	マクマホン
McMeans	マクミーンズ
McMichael	マクマイケル
McMillan	マクミラン
McMillon	マクミロン
McMullen	マクマレン
McNabb	マクナブ
McNair	マクネア
McNally	マクナリー
McNeal	マクニール
McNeil	マクニール
McNeill	マクニール
McPhearson	マクファーソン
McPherson	マクファーソン
McQuarters	マクォーターズ
McQuistan	マクイスタン
McRath	マクレス
McTyer	マクティア
Meachem	ミーチェム
Meadow	メドウ
Meadows	メドウズ
Means	ミーンズ
Mebane	ミーベイン
Meche	メッシュ
Mecklenburg	メクレンバーグ
Medlock	メドロック
Meekins	ミーキンズ
Meeks	ミークス
Meester	ミースター
Meeuwsen	ミューゼン
Meggett	メゲット
Meier	マイアー
Mel	メル
Melendez	メレンデス
Melila	メリーラ
Melky	メルキー
Melton	メルトン
Melvin	メルヴィン
Melvin	メルビン
Mench	メンチ
Mendenhall	メンデンホール
Mendoza	メンドーサ
Mensah	メンザ
Mercury	マーキュリー
Meredith	メレディス
Meriweather	メリウェザー
Merletti	マーレッティ
Merlin	マーリン
Merling	マーリング
Merrick	メリック
Merriman	メリマン
Merritt	メリット
Merriweather	メリウェザー
Merton	マートン
Merz	メルツ
Mesa	メサ
Messner	メスナー
Metcalf	メットカルフ
Metcalf	メトカフ
Metz	メッツ
Metzelaars	メッツェラース
Mewelde	メウェルデ
Meyer	マイヤー
Meyer	メイヤー
Micah	マイカ
Micah	ミカ
Michael	マイケル
Michaels	マイケルズ
Micheal	マイケル
Michelle	ミシェル
Michihiro	ミチヒロ
Mickens	ミケンズ
Mickey	ミッキー
Mickles	ミクルズ
Middlebrooks	ミドルブルックス
Middleton	ミドルトン
Mientkiewicz	ミンケイビッチ
Miguel	ミーゲル
Miguel	ミゲール
Miguel	ミゲル
Mihlhauser	ミールハウザー
Mike	マイク
Mikell	ミケール
Milan	ミラン
Milano	ミラノ
Milanovich	ミラノヴィッチ
Milburn	ミルバーン
Miles	マイルス
Miles	マイルズ
Milford	ミルフォード
Mili	ミリ
Millar	ミラー
Millard	ミラード
Milledge	ミレッジ
Millen	ミレン
Miller	ミラー
Milligan	ミリガン
Milliner	ミリナー
Millis	ミリス
Milloy	ミロイ
Mills	ミルズ
Millwood	ミルウッド
Milner	ミルナー
Milton	ミルトン
Milus	ミラス
Mims	ミムズ
Mimucci	ミムーチ
Mincey	ミンシー
Mineo	ミネオ
Miner	マイナー
Mines	マインズ
Ming	ミング
Miniaci	ミニアシ
Minor	マイナー
Minter	ミンター
Minucci	ミーヌーチ
Mirabelli	ミラベリ
Miree	ミリー
Miro	ミロ
Misi	マイサイ
Missant	ミサント
Mitch	ミッチ
Mitchell	ミッチェル
Mitre	ミトレ
Mitrione	ミトリオーニ
Mittendorf	ミッテンドルフ
Mix	ミックス
Mixon	ミクソン
Mkristo	エムクリスト
Mo	モー
Moa	モア
Moats	モウツ
Mobley	モブリー
Modell	モデール
Modkins	モドキンズ
Modrak	モドラック
Moe	モイ
Moe	モー
Moehler	モーラー
Moeller	メラー
Moffett	モフェット
Mohamed	モハメド
Mohr	モーア
Moises	モイセズ
Molina	モリーナ
Molinaro	モリナーロ
Moll	モール
Monachino	モナチーノ
Mondoe	マンドウ
Monk	モンク
Monroe	モンロー
Monsanto	モンサント
Montae	モンテイ
Montana	モンタナ
Montavious	モンタヴィオス
Monte	モンテ
Montee	モンテ
Montell	モンテル
Montez	モンテス
Montgomery	モントゴメリー
Montiese	モンティーゼ
Montique	モンティーク
Montrae	モントレイ
Monty	モンティ
Mookie	ムーキー
Moon	ムーン
Moore	ムーア
Moorehead	ムーアヘッド
Moorman	ムーアマン
Mora	モーラ
Morales	モラレス
Moran	モーラン
Morant	モラント
Moreland	モアランド
Morelli	モレリ
Morency	モレンシー
Moreno	モリーノ
Moreno	モレノ
Morey	モーリー
Morgan	モーガン
Moris	モーリス
Morley	モーレイ
Morlon	モーロン
Mormino	モルミノ
Morneau	モルノー
Mornhinweg	モーニンウェグ
Morotti	モロッティ
Morral	モーラル
Morris	モーリス
Morris	モリス
Morrison	モリソン
Morrissey	モリッシー
Morrow	モロウ
Morrow	モロー
Morse	モース
Morstead	モーステッド
Morten	モーテン
Mortensen	モーテンセン
Morton	モートン
Mose	モーズ
Moseley	モーゼリー
Moses	モーゼス
Moses	モーゼズ
Mosi	モーシ
Mosley	モズリー
Moss	モス
Mota	モタ
Motley	モトリー
Moulds	モウルズ
Mouton	ムートン
Moyer	モイヤー
Moylan	モイラン
Mozes	モーゼス
Mroz	ムラース
Mruczkowski	ムルカウスキー
Mueller	ミュラー
Mughelli	ムゲーリ
Muhammad	モハメド
Muhlbach	マーバック
Muhsin	ムシン
Muir	ミューアー
Mularkey	ムラーキー
Mulcahy	マルケイ
Mulitalo	ムリターロ
Muller	ミュラー
Mulligan	マリガン
Mullins	マリンズ
Muncie	マンシー
Muncy	マンシー
Mungro	マングロ
Muniz	ムニス
Munnerlyn	マナリン
Munoz	ムニョス
Munson	マンソン
Muro	ムロ
Murphy	マーフィ
Murphy	マーフィー
Murray	マレイ
Murray	マレー
Murrell	マレル
Murtha	マーサ
Murton	マートン
Musa	ミューザ
Musgrave	マスグレイヴ
Musinski	ムシンスキー
Musser	ムッサー
Mustard	マスタード
Myers	マイヤーズ
Myles	マイルズ
Myniya	ミナイヤ
Myrick	マイリック
Myron	ミロン
Myslinski	ミスリンスキー
N.D.	N.D.
Naanee	ナーニー
Nady	ネイディ
Naeole	ネイオリー
Nagurski	ナガースキ
Na'il	ナイール
Najeh	ナジェイ
Najm	ナジム
Nakamura	ナカムラ
Nalen	ネイレン
Nall	ノール
Nalley	ナリー
Namath	ネイマス
Namiki	ナミキ
Nance	ナンス
Nande	ナンディ
Nanton	ナントン
Napoleon	ナポレオン
Napoli	ナポリ
Nash	ナッシュ
Na'Shan	ナシャーン
Nat	ナット
Nate	ネイト
Nate	ネート
Nathan	ネイサン
Nathan	ネイト
Nathan	ネーサン
Nathaniel	ナサニエル
Natrone	ナトロン
Natson	ナトソン
Naufahu	ノーファフ
Navarre	ナヴァーレ
Navarro	ナヴァーロ
Navies	ネイヴィーズ
Nazel	ネイゼル
Naziruddin	ナジールディーン
Ndamukong	ダムコング
Ndukwe	ヌドゥクイ
Neal	ニール
Neale	ニール
Nealy	ニーリー
Neasman	ニースマン
Nece	ニース
Nedney	ネドニー
Neely	ニーリー
Nehemiah	ニーアマイア
Neil	ニール
Neill	ニール
Nelson	ネルソン
Nemmers	ネマーズ
Nerys	ネリス
Nesbit	ネズビット
Neshek	ネシェック
Neufeld	ニューフェルド
Neuheisel	ニューハイゼル
Nevers	ネヴァーズ
Newberry	ニューベリー
Newby	ニュービー
Newhan	ニューハン
Newhouse	ニューハウス
Newman	ニューマン
Newsome	ニューサム
Newson	ニューソン
Newton	ニュートン
Ngata	ナータ
Nguyen	ウィン
Nic	ニック
Nicholas	ニコラス
Nichols	ニコルズ
Nicholson	ニコルソン
Nick	ニック
Nickerson	ニッカーソン
Nickey	ニッキー
Nicks	ニックス
Nicolas	ニコラス
Nienhuis	ニーエンハイズ
Nieve	ニエベ
Niklos	ニクロス
Niko	ニコ
Nikolao	ニコラウ
Niland	ニーランド
Ninkovich	ニンコビィッチ
Niswanger	ナイスワンガー
Nitschke	ニチキ
Nix	ニックス
Nixon	ニクソン
Nkang	エンカング
Nnabuife	ナブーフィー
Nnamdi	ナムディ
Noah	ノア
Nobile	ノビレ
Nobis	ノービス
Noble	ノウブル
Noel	ノエル
Nolan	ノーラン
Noland	ノーランド
Nolasco	ノラスコ
Noll	ノール
Nook	ヌーク
Nordgren	ノードグレン
Nordin	ノーディン
Noriaki	ノリアキ
Norm	ノーム
Norman	ノーマン
Norries	ノーリス
Norris	ノリス
North	ノース
Northcutt	ノースカット
Norton	ノートン
Norv	ノーヴ
Norwood	ノーウッド
Novak	ノヴァク
Novoa	ノボア
Nowland	ナウランド
Nua	ヌーア
Nugent	ニュージェント
Nunez	ヌーネス
Nunez	ヌネス
Nunez-Roches	ヌニェス =ロチェス
Nunn	ナン
Nunnely	ナンリー
Nussmeier	ナスマイアー
Nutten	ナッテン
Nu'u	ニューユー
Nwabuisi	ワブーシー
Nwaneri	ワナリー
Nye	ナイ
Nyenhuis	ナインハイズ
Nyjer	ナイジェル
O.J.	O.J.
Oakley	オークレイ
Oates	オーツ
Obafemi	オバフィーミ
Oben	オウベン
Obeng	オウベン
Obomanu	オブマーヌー
O'Brien	オブライエン
Obum	オブーム
O'Callaghan	オキャラハン
Ochocinco	オチョシンコ
Ochs	オクス
Ockie	オッキー
O'Connell	オコネル
O'Connor	オコナー
Octavio	オクタビオ
Octobre	オクトーバー
Odalis	オダリス
Oday	オダイ
O'Dea	オウディ
Odell	オデル
Oden	オッデン
Odenthal	オーデンタール
Odom	オードム
O'Donnell	オドネル
O'Dwyer	オドワイアー
Ofenheusle	オーフェンホイスル
Offerdah	オファーダー
Offord	オフォード
O'Flaherty	オフラハティ
Ogawa	オガワ
Ogbogu	オボグ
Ogden	オグデン
Oglesby	オグレスビー
Ogunleye	オグンレエ
O'Hagan	オヘイガン
Ohalete	オーハリート
O'Hara	オハラ
Oher	オアー
Ohnesorge	オーネソージ
Ohrnberger	オーレンバーガー
Ohtaki	オオタキ
Ojinnaka	オジンナカ
Okeafor	オケイファー
O'Keith	オキース
Okobi	オコービ
Okoye	オコイエ
Okwo	オークウォー
Ola	オラ
Olajubutu	オラジャブーツー
Olaniyi	オラニイ
Oldenburg	オルデンバーグ
Olds	オールズ
O'Leary	オレアリー
Olin	オリン
Olindo	オリンド
Oliphant	オリファント
Olivadotti	オリヴァドッティ
Olive	オリーヴ
Olivea	オリヴィア
Oliver	オリヴァー
Oliver	オリバー
Olivo	オリボ
Ollie	オリー
Ollison	オリソン
Olmedo	オルメド
Olmsted	オルムステッド
Olomua	オロムア
Olsen	オルセン
Olshansky	オルシャンスキー
Olson	オルソン
Omar	オマー
Omare	オメア
Omari	オマーリ
Omiyale	オミエール
Omowale	オモワレイ
O'Neal	オニール
O'Neil	オニール
O'Neill	オニール
Onoh	オノー
Onrea	オンリー
Onterrio	オンタリオ
Onye	オニエ
Onyenegecha	オンユナゲッチャ
Opoku	オプークー
Orakpo	オクラポ
Ordonez	オルドネス
Oren	オレン
Orien	オリエン
Orlando	オーランド
Orlando	オルランド
Orlovsky	オーロヴスキー
Orpheus	オーフィアス
Orr	オア
Orr	オーア
Orrin	オーリン
Orson	オルソン
Ortega	オルテガ
Ortiz	オーティス
Ortiz	オルティス
Orton	オートン
Osborn	オズボーン
Oscar	オスカー
Osei	オセイ
Osemwegie	オセムウゲー
Osgood	オズグッド
Oshinowo	オシノフー
Osi	オウシ
Osoria	オソリア
Osterman	オスターマン
O'Sullivan	オサリヴァン
Osunde	オーサンディ
Oswalt	オズワルト
Otah	オタ
Otis	オーティス
Ottis	オティス
Otto	オットー
Outlaw	アウトロー
Overbay	オーバーベイ
Ovie	オウヴィー
Owen	オーウェン
Owens	オーウェンズ
Owens	オーエンス
Owusu	オウース
Oxendine	オクセンディン
Ozongwu	オゾンウー
Ozuna	オスーナ
Ozzie	オジー
P.J.	P.J.
P.K.	P.K.
Pablo	パブロ
Pace	ペイス
Pacman	パックマン
Padilla	パディーヤ
Pagac	パガク
Pagan	パガン
Paganelli	パガネッリ
Pagano	パガーノ
Page	ペイジ
Pago	パゴ
Paige	ペイジ
Pakulak	パクラーク
Palansky	パランスキー
Palauni	ポールオウニー
Palcic	パルシック
Palepoi	パレポイ
Palermo	パレルモ
Palko	パルコ
Palmeiro	パルメイロ
Palmer	パーマー
Panagos	パナゴス
Pannozzo	パノッツォ
Pape	ペイプ
Papelbon	パペルボン
Parcells	パーセルズ
Parham	パラム
Paris	パリス
Parker	パーカー
Parkey	パーキー
Parquet	パーケット
Parra	パーラ
Parrella	パレーラ
Parrish	パリッシュ
Parry	パリー
Parson	パーソン
Parsons	パーソンズ
Parys	パリース
Pascal	パスカル
Paschal	パスカル
Pascoe	パスコー
Pash	パッシュ
Pasha	パシャ
Pashos	パショズ
Pasqualoni	パスカローニ
Pass	パス
Pasztor	パーストル
Pat	パット
Patera	パテラ
Paterno	パターノ
Pathon	ペイソン
Patrice	パトリス
Patrick	パトリック
Patten	パッテン
Patterson	パターソン
Patton	パットン
Patulski	パトゥルスキー
Pa'u	パウ
Paul	ポール
Paulescu	パレスキュー
Pauley	ポーリー
Paulino	パウリーノ
Paulino	ポーリノ
Pavano	パヴァーノ
Pawlik	パウリク
Paxson	パクソン
Paxton	パクストン
Paymah	ペイマー
Payne	ペイン
Payton	ペイトン
Peake	ピーク
Pearce	ピアース
Pearman	ピアマン
Pears	ペアーズ
Pearson	ピアソン
Peck	ペック
Pedro	ペドロ
Pedroia	ペドロア
Peek	ピーク
Peelle	ピール
Peerless	ピアレス
Pees	ピーズ
Peete	ピート
Peko	ペコ
Pelfrey	ペルフレイ
Pellman	ペルマン
Pelon	ペロン
Pena	ペーニャ
Pence	ペンス
Pendergast	ペンダーガスト
Pendergrass	ペンダーグラス
Pendry	ペンドリー
Penn	ペン
Pennel	ペネル
Pennington	ペニントン
Peoples	ピープルズ
Pep	ペップ
Pepper	ペッパー
Peppers	ペパーズ
Peprah	ペプラー
Peralta	ペラルタ
Percy	パーシー
Perea	ペレア
Pereira	ペレイラ
Perez	ペレス
Perkins	パーキンス
Perlman	パールマン
Perry	ペリー
Pete	ピート
Peter	ピーター
Peterman	ピターマン
Peters	ピーターズ
Peterson	ピーターソン
Petitgout	ペティグー
Petitti	ペティット
Petrino	ペトリーノ
Petrowski	ペトロウスキー
Pettigrew	ペティグルー
Pettis	ペティス
Pettitte	ペティート
Pettrey	ペトリー
Pettway	ペトウェイ
Petty	ぺティ
Peyton	ペイトン
Phelan	フェラン
Phelps	フェルプス
Phifer	ファイファー
Phil	フィル
Philbin	フィルビン
Philip	フィリップ
Philippe	フィリップ
Phillip	フィリップ
Phillips	フィリップス
Philmore	フィルモア
Philpot	フィルポット
Phinisee	フィニシー
Piazza	ピアザ
Pickens	ピケンズ
Pickett	ピケット
Pie	パイ
Pierce	ピアース
Pierre	ピエール
Pierre-Louis	ピエール=ルイ
Pierre-Paul	ピエール - ポール
Pierson	ピアソン
Pierzynski	ピアジンスキー
Pietrowski	ピエトロウスキー
Pile	パイル
Piller	ピラー
Pimentel	ピメンテル
Pinderhughes	ピンダーヒュージス
Pinegar	ピネガー
Pinkard	ピンカード
Pinkie	ピンキー
Pinkney	ピンクニー
Pinkston	ピンクストン
Pinner	ピナー
Pinnix	ピニックス
Pinnock	ピノック
Pino	ピノ
Pinson	ピンソン
Pinto	ピント
Pioli	ピオーリ
Pippens	ピッペンズ
Pippin	ピピン
Pisa	ピーサ
Piscitelli	ピスクテリー
Pitcock	ピトコック
Pitoitua	ピトトゥア
Pitta	ピッタ
Pittman	ピットマン
Pitts	ピッツ
Placido	プラシド
Plackemeier	プラックマイアー
Platz	プラッツ
Plaxico	プラクシコ
Player	プレイヤー
Plummer	プラマー
Plunkett	プランケット
Pociask	ポーチャスク
Podlesh	ポドレッシュ
Podsednik	ポドセドニク
Poe	ポー
Pola	ポーラ
Polamalu	ポラマル
Polanco	ポランコ
Polian	ポリアン
Polite	ポライト
Polk	ポーク
Pollack	ポラック
Pollard	ポラード
Polley	ポリー
Pompey	ポンペイ
Ponder	ポンダー
Pontbriand	ポントブリアンド
Pool	プール
Poole	プール
Pope	ポウプ
Poppinga	ポピンガ
Porcher	ポーチャー
Porter	ポーター
Portis	ポーティス
Posada	ポサーダ
Posey	ポウジー
Posluszny	ポスルーズニー
Postell	ポステール
Poston	ポストン
Poteat	ポーティート
Potter	ポーター
Pouha	パウア
Pouncey	パウンシー
Pousson	プーソン
Powdrell	パウドレル
Powell	パウェル
Powell	パウエル
Powers-Neal	パワーズニール
Poyer	ポイヤー
Prado	プラド
Prall	プラール
Prater	プレイター
Preas	プレアス
Prescott	プレスコット
Preston	プレストン
Price	プライス
Priefer	プリーファー
Priest	プリースト
Prince	プリンス
Printers	プリンターズ
Prioleau	プリオロー
Prior	プライアー
Prisby	プリスビー
Proctor	プロクター
Proehl	プロウル
Provost	プロヴォウスト
Prude	プルード
Pruitt	プリューイット
Pruneda	プルネーダ
Pryce	プライス
Pryor	プライアー
Pucillo	プッチーロ
Pudewell	プードウェル
Pullum	プラム
Puloka	プルークウ
Punto	プント
Purcell	パーセル
Purdum	パードン
Purify	プリフィ
Putnam	パトナム
Putz	プッツ
Putzier	パツィアー
Pyatt	ピヤット
Pyne	パイン
Qadry	カドリー
Qasim	カジム
Quadtrine	クワッドトライン
Qualls	クオールズ
Quarles	クウォールズ
Quarshie	クォーシー
Quarterman	クォーターマン
Quartez	カルテス
Quentily	クエンティリー
Quentin	クエンティン
Quigley	クイグリー
Quillen	クィレン
Quin	クイン
Quincy	クインシー
Quinlan	クインラン
Quinn	クィン
Quinn	クイン
Quinnie	キーニー
Quinones	キノネス
Quintero	クインテーロ
Quintin	クインティン
Quinton	クイントン
Qvale	クーベル
R.C.	R.C.
R.J.	R.J.
R.W.	R.W.
Rabach	ラバック
Rabb	ラブ
Rabe	レイブ
Rabelo	ラベロ
Rabih	ラビー
Raburn	ラバーン
Race	レイス
Rachel	レイチェル
Rackers	ラッカーズ
Rackley	ラックリー
Radakovich	ラダコヴィッチ
Radell	ラデル
Rader	ラダー
Radhames	ラドアメス
Raekwon	レイクウォン
Rafael	ラファエル
Ragland	ラグランド
Ragone	ラゴーン
Raheem	ラヒーム
Raich	ライク
Rainer	レイナー
Raiola	レイオーラ
Raji	ラジ
Rakeem	ラキーム
Ralph	ラルフ
Ramel	ラメル
Ramik	ラミック
Ramirez	ラミレス
Ramiro	ラミロ
Ramon	ラモン
Ramon	レイモン
Ramonce	ラモンス
Ramondo	ラモンド
Ramsdell	ラムズデール
Ramsey	ラムジー
Ramzee	ラムジー
Ran	ラン
Randal	ランドール
Randall	ランドール
Randee	ランディー
Randle	ランドル
RandleEl	ランドルエル
Randolph	ランドルフ
Randy	ランディ
Ransom	ランサム
Rantanen	ランタネン
Raonall	ラオノール
Rapada	ラパダ
Rasby	ラズビー
Rashad	ラシャッド
Rashard	ラシャード
Rashaun	ラショーン
Rashawn	ラシャウン
Rashean	ラシーン
Rasheed	ラシード
Rashied	ラシード
Rashon	ラション
Rasmussen	ラズムーセン
Rathman	ラスマン
Ratliff	ラトリフ
Rattay	ラテイ
Rauch	ラウチ
Raul	ラウル
Ray	スミス
Ray	レイ
Rayburn	レイバーン
Raye	レイ
Rayfield	レイフィールド
Raymer	レイマー
Raymond	レイモンド
Rayner	レイナー
Raynoch	レイノク
Rayshun	レイション
Razzano	ラザノ
Read	リード
Reagan	リーガン
Reagor	リーガー
Reaves	リーヴズ
Reche	リチェ
Rector	レクター
Red	レッド
Redd	レッド
Reddick	レディック
Redding	レディング
Redman	レッドマン
Redmon	レドモン
Redmond	レッドモンド
Redmond	レドモンド
Reed	リード
Reels	リールズ
Reese	リース
Reeves	リーヴズ
Reg	レジ
Reggie	レジー
Rehage	リーヘイジ
Reich	ライク
Reid	リード
Reilly	レイリー
Reimer	ライマー
Reinfeldt	ラインフェルト
Reis	リース
Reitsma	リーツマ
Remi	レミー
Remmel	レメル
Remy	レミー
Renaldo	レナルド
Renardo	レナード
Renauld	レナウルド
Reno	リノ
Renteria	レンテリア
Renyel	レイネル
Reshad	レシャード
ReShard	レシャード
Resop	リソップ
Retkofsky	レトコフスキー
Reuben	ルーベン
Reuber	ルーバー
Reuland	ルーランド
Reveiz	レヴェイツ
Revis	リービス
Rex	レックス
Rey	レイ
Reyes	レイエス
Reynaldo	レイナルド
Reynolds	レイノルズ
Rheem	リーム
Rheinecker	ラインネッカー
Rhema	レーマ
Rhoades	ロウズ
Rhodes	ローズ
Rhys	リース
Rian	ライアン
Ricard	リカード
Ricardo	リチャード
Rice	ライス
Rich	リッチ
Richar	リチャー
Richard	リチャード
Richardson	リチャードソン
Richey	リッチー
Richie	リッチー
Richmond	リッチモンド
Rick	リック
Ricker	リッカー
Rickey	リッキー
Rickie	リッキー
Ricky	リッキー
Rico	リコ
Riddle	リドル
Rideau	リドウ
Rideaux	リドー
Ridgeway	リジウェイ
Ridgway	リッジウェイ
Ridley	リドリー
Riemersma	リーマズマ
Rien	リエン
Riggins	リギンズ
Riggs	リグズ
Riki	リキ
Rikiya	リキヤ
Riley	ライリー
Rimpf	リンフ
Rincon	リンコン
Ring	リング
Ringer	リンガー
Rios	リオス
Riske	リスキー
Rissler	リスラー
Rita	リタ
Ritchie	リッチー
Ritzmann	リッツマン
Rivas	リーヴァス
Rivera	リヴェラ
Rivera	リベラ
Rivers	リバーズ
R-Kal	Ｒ－カル
Roach	ローチ
Roaf	ロウフ
Rob	ロブ
Robaire	ロベア
Robb	ロブ
Robbie	ロビー
Robbins	ロビンズ
Robby	ロビー
Roberson	ロバーソン
Robert	ロバート
Robert	ロベルト
Roberto	ロベルト
Roberts	ロバーツ
Robertson	ロバートソン
Robin	ロビン
Robinson	ロビンソン
Robiskie	ロビスキー
Robison	ロビソン
Robles	ロブレス
Robustelli	ロブステーリ
Roby	ロビー
Roc	ロック
Rocca	ロッカ
Rock	ロック
Rocker	ロッカー
Rockett	ロケット
Rocky	ロッキー
Rod	ロッド
Roddy	ロディ
Roderick	ロデリック
Rodgers	ロジャーズ
Rodgers-Cromartie	ロジャースクロマティ
Rodney	ロドニー
Rodriguez	ロドリゲス
Rodrique	ロドリーク
Roehl	ロウル
Roethlisberger	ロスリスバーガー
Roger	ロジャー
Rogers	ロジャーズ
Rohan	ロウハン
Rohde	ローデ
Rohloff	ローロフ
Roland	ローランド
Rolando	ローランド
Rolapp	ロラップ
Roldan	ロルダン
Rolf	ロルフ
Roll	ロール
Rolle	ロール
Rollins	ロリンズ
Roman	ローマン
Roman	ロマン
Romanowski	ロマノウスキー
Romar	ローマー
Romberg	ロンバーグ
Romby	ロムビー
Romeo	ロメオ
Romero	ロメーロ
Romero	ロメロ
Romo	ロモ
Romulo	ロムロ
Ron	ロン
Ronald	ロナルド
Ronde	ロンデ
Rondell	ロンデル
Ronnie	ロニー
Ronny	ロニー
Rontez	ロレンテズ
Ronyell	ロニエル
Rooney	ルーニー
Roos	ロウス
Roosevelt	ルーズベルト
Ropati	ロパティ
Roper	ローパー
Roque	ロケ
Rory	ローリー
Rosa	ローザ
Rosario	ロザリオ
Rosburg	ロスバーグ
Roscoe	ロスコウ
Rose	ローズ
Rosenfels	ローゼンフェルズ
Rosenhaus	ローゼンハウス
Rosenthal	ローゼンサル
Rosevelt	ルーズヴェルト
Rosey	ロージー
Roshon	ローショーン
Ross	ロス
Rossley	ロスリー
Rossner	ロスナー
Rossum	ロッサム
Roth	ロース
Rottino	ロティーノ
Rouen	ルーイン
Rouse	ラウス
Routt	ラウト
Rowan	ローワン
Rowand	ローワンド
Rowe	ロウ
Rowen	ロウエン
Rowland-Smith	スミス
Roy	ロイ
Royal	ロイヤル
Royce	ロイス
Roydell	ロイデル
Roye	ロイ
Roynell	ロイネル
Rozelle	ロゼール
Rubbert	ルバート
Ruben	ルーベン
Rubin	ルービン
Rucker	ラッカー
Ruddy	ルディ
Rudi	ルディ
Rudy	ルディ
Rueben	ルーベン
Ruegamer	ルーガマー
Ruettgers	ラトガース
Ruff	ラフ
Rufus	ルーファス
Ruiz	ルイス
Rulon	ルーロン
Rumph	ランフ
Runnels	ラネルズ
Runyan	ランヤン
Rupe	ループ
Rushing	ラッシング
Ruskell	ラスケル
Russ	ラス
Russell	ラッセル
Ruston	ラストン
Rusty	ラスティ
Rutherford	ラザフォード
Rutigliano	ルティリアーノ
Rutledge	ラトリッジ
Ruud	ルード
Ruvell	ルーベル
Ryan	ライアン
Ryans	ライアンズ
Rydze	ライツェ
Ryne	ライン
Ryoma	リョウマ
Ryon	ライオン
Ryota	リョウタ
Rypien	リッピン
S.Davis	デイヴィス
Saalim	サーリム
Saban	セイバン
Sabathia	サバシア
Sabby	サビー
Sabol	セイボル
Saccomano	サッコマーノ
Sage	セイジ
Saipaia	サイパイア
Sal	サル
Salaam	サラーム
Salas	サラス
Salave'a	サラヴェイア
Saldi	サルディ
Saleem	セーラム
Salkin	サルキン
Salley	サリー
Salmon	サーモン
Salomon	サロモン
Saltalamacchia	サルタラマッキア
Sam	サム
Samardzija	サマージャ
Samari	サマリ
Samario	サマリオ
Sambrailo	サムブレイロ
Sameeh	サミー
Sami	サミ
Samie	サミー
Samir	サミール
Samkon	サムコン
Sammy	サミー
Samp	サンプ
Sampson	サンプソン
Sampy	サンピー
Sams	サムズ
Samson	サムソン
Samuel	サミュエル
Samuels	サミュエルズ
Sanborn	サンボーン
Sanchez	サンチェス
Sander	サンダー
Sanders	サンダース
Sandidge	サンディッジ
Sandino	サンディーノ
Sandoval	サンドヴァル
Sands	サンズ
Sandusky	サンダスキー
Sandy	サンディ
Sanford	サンフォード
Sanjay	サンジェイ
Santana	サンタナ
Santiago	サンティアゴ
Santonio	サントニオ
Santos	サントス
Santucci	サントゥーチ
Sanu	サヌー
Sape	セイプ
Sapp	サップ
Saracino	サラシーノ
Sardisco	サルディスコ
Sarfate	サーフェイト
Sarkisian	サルキシャン
Sarth	サース
Sartz	サーツ
Sasha	サーシャ
Satele	サテレイ
Saturday	サタデイ
Saubert	ソーバート
Sauer	サウアー
Sauerbrun	サウワーブラン
Saul	サウル
Saul	ソウル
Saunders	サンダース
Saunders	ソーンダース
Sauter	ソーター
Savage	サヴェイジ
Save	セイヴ
Saverio	サヴェリオ
Sawyer	ソウヤー
Saxon	サクソン
Saxton	サクストン
Sayers	セイヤーズ
Scaife	スカーイフ
Scandrett	スキャンドレット
Scanlon	スキャンロン
Scates	スケイツ
Schable	シェイブル
Schaffer	シェイファー
Schafrath	シェイフラス
Schar	シェアー
Scharf	シャーフ
Scharff	シャーフ
Schaub	ショーブ
Scheffler	シェフラー
Schembechler	シェンベクラー
Schiano	スキアーノ
Schifino	シフィーノ
Schilens	シレンス
Schilling	シリング
Schimmelmann	シメルマン
Schlauderaff	シュラウダラフ
Schlegel	シュレーゲル
Schlesinger	シュレシンガー
Schmale	シュマーレ
Schmidt	シュミット
Schmitt	シュミット
Schneck	シュネック
Schnee	シュニー
Schneider	シュナイダー
Schobel	スコーベル
Schober	ショーバー
Schoeneweis	ショーネワイス
Schonert	ショウナート
Schottenheimer	ショッテンハイマー
Schouman	シューマン
Schraeder	シュリーダー
Schrage	シュラギー
Schramm	シュラム
Schroder	シュレーダー
Schroeder	シュレーダー
Schulters	シャルターズ
Schurman	シャーマン
Schwartz	シュヴァルツ
Schweigert	シュウェイガート
Schweitzer	シュヴァイツァー
Scifres	シフレス
Sciullo	シウーロ
Scobee	スコビー
Scobey	スコウビー
Scot	スコット
Scott	スコット
Scotty	スコッティ
Scutaro	スクタロ
Sean	ショーン
Seante	ショーンティ
Seantrel	セントレル
Sears	シアーズ
Seau	セイオウ
Seawright	シーライト
Seay	シーエイ
Sebastian	セバスチャン
Seddon	セドン
Sedrick	シードリック
Seferian-Jenkins	セフィリアン-ジェンキンス
Segal	シーガル
Seidman	シードマン
Seifert	シーファート
Seigler	セイグラー
Sele	シーリー
Sele	スレイ
Sellers	セラーズ
Selvin	セルヴィン
Sempey	サンペイ
Semple	センプル
Sen'Derrick	センデリック
Sendlein	センドライン
Seneca	セネカ
Senorise	セノリス
Sensabaugh	センサボー
Seppo	セプオ
Sepulveda	セプルヴェダ
Sergey	セルゲイ
Sergio	セルジオ
Serna	セルナ
Session	セッション
Seth	セス
Setta	セッタ
Setterstrom	セターストロム
Seubert	シューバート
Seward	シュワード
Sewell	シューエル
Sexson	セクソン
Sexton	セクストン
Seymour	シーモア
Shabazz	シャバーズ
Shackelford	シャッケルフォード
Shackleford	シャックルフォード
Shad	シャド
Shafer	シェイファー
Shaffer	シャファー
Shaine	シャイーン
Shamarko	シャマルコ
Shanahan	シャナハン
Shane	シェイン
Shane	シェーン
Shanks	シャンクス
Shanle	シャンル
Shannon	シャノン
Shantee	シャンティー
Shaq	シャック
Shareece	シャリース
Sha'reff	シャレフ
Sharon	シャロン
Sha-Ron	シャロン
Sharp	シャープ
Sharpe	シャープ
Sharper	シャーパー
Sharpless	シャープレス
Sharrod	シャロッド
Shaud	シャウド
Shaughnessy	ショーネシー
Shaun	ショーン
Shaunard	ショーノード
Shaw	ショー
Shawn	ショーン
Shawne	ショーン
Shawntae	ショーンティ
Shayne	シェイン
Shazor	シャゾア
Shea	シェイ
Shealy	シェーリー
Shearn	シェーン
Sheets	シーツ
Sheffey	シェフィー
Sheffield	シェフィールド
Shelby	シェルビー
Sheldon	シェルドン
Shell	シェル
Shelley	シェリー
Shelmon	シェルモン
Shelton	シェルトン
Shen	シェン
Shepherd	シェパード
Sheppard	シェパード
Sherman	シャーマン
Shermar	シャーマー
Sherrard	シェラード
Sherrell	シェレル
Sherrill	シェリル
Sherrod	シェロッド
Shiancoe	シアンコウ
Shields	シールズ
Shipp	シップ
Shirdonya	シャドーニヤ
Shivers	シヴァーズ
Shoate	ショートゥ
Shockey	ショッキー
Shockley	ショックリー
Shofner	ショフナー
Shonn	ショーン
Shoop	シュープ
Shoppach	ショパッチ
Shor	ショア
Short	ショート
Shortslef	ショーツレフ
Shortt	ショート
Shotwell	ショットウェル
Shouse	シャウス
Shropshire	シュロップシャー
Shuey	シューイ
Shugarts	シュガーツ
Shula	シューラ
Shuler	シュラー
Shurendy	シュレンディ
Shurmur	シューマー
Shurron	シャロン
Siavii	シアヴィ
Sid	シド
Siddeeq	シディーク
Sidney	シドニー
Siegert	シーガート
Signora	シグノーラ
Silberman	シルバーマン
Siler	サイラー
Silva	シルヴァ
Silva	シルバ
Simeon	シメオン
Simmons	シモンズ
Simms	シムズ
Simnjanovski	シンヤノフスキー
Simon	サイモン
Simoneau	シモノー
Simontacchi	サイモンタッキ
Simonton	シモントン
Simpson	シンプソン
Sims	シムズ
Sims-Walker	シムズウォーカー
Sinclair	シンクレア
Singletary	シングレタリー
Singleton	シングルトン
Sinorice	シノリス
Sione	サイオン
Sipe	サイプ
SirHenry	サーヘンリー
Sirmon	サーモン
Siskowic	シスコウィック
Sizemore	サイズモア
Skillern	スキラーン
Skinner	スキナー
Skip	スキップ
Skipper	スキッパー
Skrine	スクライン
Skyler	スカイラー
Slack	スラック
Slater	スレイター
Slaton	スレイトン
Slaughter	スローター
Slauson	スローソン
Slavin	スレイヴィン
Slay	スレイ
Sloan	スローン
Slocum	スローカム
Slowey	スロウリー
Slowik	スロウィック
Small	スモール
Smart	スマート
Smerlas	スマーラス
Smiley	スマイリー
Smith	スミス
Smith-Anderson	スミスアンダーソン
Smoker	スモーカー
Smolko	スモルコ
Smoltz	スモルツ
Smoot	スムート
Smyth	スマイス
Snead	スニード
Snee	スニー
Snell	スネル
Snelling	スネリング
Snow	スノウ
Snyder	スナイダー
Sobieski	ソビエスキー
Sobomehin	ソボメイン
Softli	ソフトリ
Solano	ソラーノ
Solari	ソラーリ
Soliai	ソリーアイ
Solomon	ソロモン
Sommersell	ソマーセル
Sonnanstine	ソナンスタイン
Sonny	ソニー
Sopoaga	ソポアガ
Sorensen	ソレンセン
Sorgi	ソルジ
Soria	ソリア
Soriano	ソリアーノ
Sosa	ソーサ
Soto	ソト
Sowell	サウェル
Sowells	ソーウェルズ
Spach	スパーク
Spadola	スパードラ
Spaeth	スペース
Spagnuolo	スパグニュオロ
Spani	スパーニ
Spann	スパン
Spanos	スパノス
Sparano	スパラーノ
Sparling	スパーリング
Spears	スピアーズ
Speck	スペック
Speegle	スピーグル
Speier	スパイアー
Spencer	スペンサー
Spicer	スパイサー
Spielman	スピルマン
Spikes	スパイクス
Spiller	スピラー
Spinner	スピナー
Spires	スパイアーズ
Spitz	スピッツ
Spragan	スプレイガン
Springs	スプリングス
Sproles	スプロールズ
Spurlock	スパーロック
Spurrier	スパリアー
St.Clair	セントクレア
St.Eloi	サンテロワ
St.Louis	セントルイス
St.Pierre	セントピエール
Staat	スタート
Stabile	ステイビール
Stabler	ステイブラー
Stacey	ステイシー
Stacy	ステイシー
Stafford	スタフォード
Staggs	スタッグス
Stairs	ステアーズ
Staley	ステイリー
Stallings	スターリングス
Stallworth	ストールワース
Stamer	ステイマー
Stamps	スタンプス
Stan	スタン
Stanback	スタンバック
Standeford	スタンドフォード
Stanford	スタンフォード
Staninger	スタニンガー
Stanley	スタンリー
Stanton	スタントン
Stapleton	ステイプルトン
Starks	スタークス
Starling	スターリング
Starr	スター
Staton	ステイトン
Staubach	ストーバック
Stautner	ストートナー
Steadman	ステッドマン
Stecker	ステッカー
Steele	スティール
Steen	スティーン
Stef	ステフ
Stefan	ステファン
Steffes	ステフス
Stefon	ステフォン
Steinbach	スタインバック
Steinberg	スタインバーグ
Steinbrunner	スタインブルナー
Steiner	ステイナー
Steinhauser	シュタインホイザー
Steitz	スタイツ
Stellmacher	ステルマーカー
Stelly	ステリー
Stenavich	ステナヴィッチ
Stenerud	スティーネルード
Stepanovich	ステパノヴィッチ
Stephen	スティーブン
Stephens	スティーブンズ
Stephenson	スティーブンソン
Stephon	ステファン
Stephone	ステフォン
Stepnoski	ステプノスキー
Steptoe	ステプトー
Sterling	スターリング
Stetter	ステッター
Steussie	ストゥーシー
Stevan	スティーブン
Steve	スティーヴ
Steve	スティーブン
Steven	スティーヴ
Steven	スティーヴン
Stevens	スティーヴンズ
Stevenson	スティーヴンソン
Stewart	スチュワート
Stewart	ステュワート
Stickdorn	スティックドーン
Stiles	スタイルズ
Stills	スティルズ
Stinchcomb	スティンチコム
Stingley	スティングリー
Stinson	スティンソン
Stith	スティス
Stocco	ストッコ
Stock	ストック
Stockar	ストッカー
Stockman	ストックマン
Stokes	ストウクス
Stokes	ストークス
Stokley	ストークリー
Stone	ストーン
Stoops	ストゥープス
Storck	ストーク
Storer	ストラー
Stoutmire	スタウトマイアー
Stovall	ストーヴァル
Stover	ストーヴァー
Stoyanovich	ストウヤノヴィッチ
Strahan	ストレイハン
Strait	ストレイト
Stram	ストラム
Stratton	ストラットン
Street	ストリート
Strickland	ストリックランド
Strief	ストリーフ
Stringer	ストリンガー
Strojny	ストロニー
Strong	ストロング
Stroud	ストラウド
Stuart	スチュワート
Stubblefield	スタブルフィールド
Stubbs	スタッブス
Stuber	ストゥーバー
Stuckey	スタッキー
Studdard	スタッダード
Studesville	ステューデスヴィル
Studwell	スタッドウェル
Stukes	ストゥークス
Stull	スタル
Stutz	スタッツ
Stuvaints	ストゥヴェインツ
Sudfeld	サドフェルド
Sugarman	シュガーマン
Suggs	サッグス
Suh	スー
Suisham	スイシャム
Sulecio	スレシオ
Suleiman	スレイマン
Sullivan	サリヴァン
Sultan	サルタン
Sumlin	サムリン
Summers	サマーズ
Sundquist	サンドクイスト
Supovitz	サポヴィッツ
Suppan	スーパン
Surrency	サレンシー
Surtain	サーテン
Sutton	サットン
Suzuki	スズキ
Svare	スヴァーレ
Sverchek	スヴァーチェク
Svitek	スヴィテク
Swain	スウェイン
Swancutt	スワンカット
Swann	スワン
Sweatman	スウェットマン
Sweeney	スウィーニー
Swift	スウィフト
Swilling	スウィリング
Swinton	スウィントン
Swisher	スウィシャー
Switzer	スウィッツァー
Swogger	スウォガー
Sykes	サイクス
Sylvan	シルヴァン
Symons	シモンズ
Syndric	シンドリック
Syoei	ショウエイ
Sypniewski	シプニエウスキー
Syptak	シプタク
Syvelle	サヴェル
Szabo	サボ
Szalay	チャーラーイ
Szott	ゾット
T.J.	T.J
T.J.	T.J.
Tab	タブ
Tabb	タッブ
Tack	タック
Taco	タコ
Tadahito	タダヒト
Tafisi	タフィーシー
Tafoya	タフォーヤ
Tagliabue	タグリアブー
Tahi	ターイ
Tait	タイト
Taiwan	タイワン
Tajh	タジャ
Takavitz	ターカヴィッツ
Takeo	タキーオ
Takkarist	タカリスト
Tala	タラー
Talavou	タラヴー
Tallet	タレット
Talley	タリー
Talman	タルマン
Tamba	タンバ
Tanard	タナード
Tank	タンク
Tankersley	タンカースリー
Tannehill	タネヒル
Tannenbaum	タネンバウム
Tanner	タナー
Tanny	タニー
Tanoh	タノー
Tanuvasa	タニューヴァサ
Tapeh	タフェ
Tapp	タップ
Tarell	タレル
Tarik	タリック
Tarkenton	ターケントン
Tarquinio	タルキーニオ
Tarullo	タルーロ
Tarvaris	ターヴァリス
Tashard	トゥシャード
Tasker	タスカー
Tata	タタ
Tate	テイト
Tatum	テイタム
Tatupu	タトゥープ
Taulealea	トーリーリー
Taurean	トーリアン
Tauscher	トーシャー
Tavares	タヴァレス
Taver	テイヴァー
Tavo	タヴォ
Taye	テイ
Taylor	テイラー
Taylor	テーラー
Teague	ティーグ
Teahen	ティーエン
Teal	ティール
Tearrius	ティアリアス
Tebow	ティーボウ
Tebucky	テバッキー
Ted	テッド
Teddy	テディ
Tedy	テディ
Teel	ティール
Teeuws	テューズ
Teixeira	ティシェイラ
Tejada	テハダ
Tejeda	テヘダ
Tella	テラ
Tellis	テリス
Telp	テルプ
Terdell	ターデル
Terence	テレンス
Teresa	テレサ
Terna	ターナ
Terrail	テライユ
Terrance	テランス
Terrance	テレンス
Terreal	テリール
Terrell	テレール
Terrell	テレル
Terrelle	テレル
Terrence	テレンス
Terrill	テリール
Terron	テロン
Terry	テリー
Terwilliger	ターウィリンガー
Teryl	テリル
Tessalone	テッサローン
Testaverde	テスタヴァーディ
Tevin	テビン
Tevita	テビタ
Tex	テックス
Teyo	テイヨ
Thaddaeus	タディーアス
Thames	テームズ
Thatcher	サッチャー
Theismann	サイズマン
Theo	テオ
Theodric	テドリック
Theriot	セリオ
Therrian	セリアン
Thibedaux	ティベドゥー
Thigpen	シグペン
Thomas	トーマス
Thomason	トーマソン
Thome	トーミ
Thompkins	トンプキンズ
Thompson	トンプソン
Thomson	トムソン
Thorman	ソーマン
Thorn	トーン
Thornburg	ソーンバーグ
Thornton	ソーントン
Thorpe	ソープ
Thrash	トラッシュ
Threat	スレット
Thump	サンプ
Thurman	サーマン
Tice	タイス
Tike	タイク
Tiki	ティキ
Tillman	ティルマン
Tim	ティム
Timi	ティマイ
Timlin	ティムリン
Timmerman	ティマーマン
Timmons	ティモンズ
Timmy	ティミー
Timo	ティモ
Timothee	ティモーテイ
Timothy	ティム
Timothy	ティモシー
Tinch	ティンチ
Tinoisamoa	ティノイサモーア
Tinsley	ティンズリー
Tippett	ティペット
Tiquan	ティキアン
Tisch	ティッシュ
Titley	ティトリー
Tittle	ティトル
Titus	タイタス
Toal	トール
Tobeck	トーベック
Tobin	トービン
Toby	トビー
Tod	トッド
Todd	トッド
Toeaina	トウイーナー
Toefield	トウフィールド
Toews	トーズ
Togafau	トーガファウー
Toilolo	トイロロ
Tolbert	トルバート
Toledo	トレド
Toler	トーラー
Toles	トールズ
Tollefson	トレフソン
Tollner	トールナー
Tolver	トルヴァー
Tom	トム
Tomlin	トムリン
Tomlinson	トムリンソン
Tommie	トミー
Tommy	トミー
Tomsula	トムシューラ
Tongue	タング
Toni	トニー
Toniu	トニウ
Tony	トニー
Toomer	トゥーマー
Toone	トゥーン
Topcu	トプチュ
Torbor	トーバー
Torii	トリー
Torp	トープ
Torrance	トランス
Torrence	トランス
Torres	トーレス
Torrey	トーリー
Torrian	トリアン
Torrie	トリー
Torrin	トリン
Torry	トリー
Tory	トリー
Tossell	トッセル
Toub	トーブ
Toudouze	トウドウゼ
Towbridge	トローブリッジ
Towers	タワーズ
Towles	クインテーロ
Towns	タウンズ
Townsell	タウンセル
Townsend	タウンゼンド
Tra	トレイ
Tracey	トレイシー
Tracy	トレイシー
Trae	トレエ
Trafford	トラフォード
Trai	トレイ
Tramain	トレメイン
Tramon	トラモン
Trannon	トラノン
Trask	トラスク
Travares	トラヴァレス
Travarous	トルヴァラス
Travelle	トラヴェル
Travis	トラヴィス
Travis	トラビス
Traylor	トレイラー
Traynor	トレイナー
Tre	トレイ
Tre'	トレイ
Treanor	トレナー
Treaudo	トルード
Tre'Davious	トレデビウス
Trent	トレント
Trenton	トレントン
Tres	トレス
Tressel	トレッセル
Trestin	トレスティン
Trestman	トレストマン
Treu	トゥルー
Trev	トレヴ
Trever	トレバー
Trevis	トレヴィス
Trevor	トレヴァー
Trey	トレイ
Triandos	トリアンドス
Trimble	トリンブル
Trindon	トリンドン
Triplette	トリプレット
Tripp	トリップ
Trippi	トリッピ
Tripplett	トリプレット
Trot	トロット
Trotter	トロッター
Troupe	トロウプ
Troy	トロイ
Trucks	トラックス
Trudell	トゥルーデル
Trueblood	トゥルーブラッド
Trufant	トゥルファント
Truluck	トゥルラック
Trumaine	トラメイン
Trusnik	トラスニック
Trusty	トラスティ
Tryon	トライオン
Tubbs	タッブス
Tuberville	トゥバーヴィル
Tuck	タック
Tucker	タッカー
Tuell	トゥール
Tuff	タフ
Tufts	タフツ
Tuggle	タグル
Tui	トゥーイー
Tuiasosopo	トゥイアソソーポ
Tulloch	タラク
Tully	タリー
Tuman	トゥーマン
Tunsil	タンシル
Tupa	トゥーパ
Tupa'i	トゥーパイ
Tupe	トゥープ
Tupola	トゥーポウラ
Turk	ターク
Turley	ターリー
Turnbow	ターンボー
Turnbull	ターンブル
Turner	ターナー
Tutan	トゥータン
Tuten	トゥーテン
Tutt	タット
Twan	トワン
Tweedie	トウィーディ
Twito	トウィット
Twyman	トワイマン
Ty	タイ
Tye	タイ
Tyer	タイアー
Tyjuan	タイワン
Tyke	タイク
Tyler	タイラー
Tylski	ティルスキー
Tyner	タイナー
Tynes	タインス
Tyoka	ティオカ
Tyree	タイリー
Tyreek	タイリーク
Tyrell	タイレル
Tyrod	タイロッド
Tyron	タイロウン
Tyrone	タイロウン
Tyronne	タイロウン
Tyson	タイソン
Tyvon	タイボン
Uberstine	ウバースティン
Uche	ウーチー
Udeze	ウディーゼ
Uggla	アグラ
Ugoh	ユーゴー
Ukee	ユーキー
Ukeme	ユーキム
Ulbrich	アルブリッチ
Ulish	アリッシュ
Ulmer	アルマー
Ulrich	アルリック
Ulrich	ウルリッヒ
Umberto	アンバートー
Umenyiora	ウメニオーラ
Unck	アンク
Underwood	アンダーウッド
Undlin	アンドリン
Undrey	アンドレイ
Unitas	ユナイタス
Uperesa	ウーパーレサ
Upshaw	アップショー
Upton	アップトン
Urban	アーバン
Uribe	ウリーベ
Urlacher	アーラッカー
Usama	オーサマ
Utecht	ユーテク
Utley	アットリー
Utley	アトリー
Uwe	ウーヴェ
Uyi	ウーイー
Vaas	ヴァース
Vaka	ヴァカ
Val	ヴァル
Valentin	ヴァレンティン
Valentin	バレンティン
Valero	ヴァレロ
Vallejo	ヴァレイオ
Vallos	ヴァロス
Van	ヴァン
VanBenschoten	バンベンショッテン
VanBuren	ヴァンバレン
Vance	ヴァンス
Vance	バンス
VandenBosch	ヴァンデンボッシュ
VandenHurk	バンデンホーク
Vanderjagt	ヴァンダージャット
VanDeSteeg	ヴァンデスティーグ
VanEeghen	ヴァンイーフェン
VanGorder	ヴァンゴーダー
VanHoy	ヴァンホイ
Vann	ヴァン
Vannieuwenhoven	ヴァニエウェホーヴェン
VanNote	ヴァンノート
VanPelt	ヴァンペルト
Vargas	ヴァルガス
Vargas	バルガス
Varitek	ヴァリテック
Vasher	ヴァシャー
Vashon	ヴァショーン
Vasquez	バスケス
Vaughan	ヴォーン
Vaughn	ヴォーン
Vazquez	バスケス
Veal	ヴィール
Vedder	ヴェッダー
Velasquez	ヴェラスケス
Ventrone	ヴェントロン
Venturi	ヴェントゥーリ
Verba	ヴァーバ
Vercher	ヴァーチャー
Verdon	ヴァードン
Verducci	ヴェルドゥッチ
Verdun-Wheeler	ヴァーダンウィーラー
Verlander	バーランダー
Vermeil	ヴァミール
Vermillion	ヴァーミリオン
Vernand	ヴァーナンド
Vernell	ヴァーネル
Verner	バーナー
Vernon	ヴァーノン
Vernon	ヴァーロン
Verron	ヴェロン
Viano	ヴィアノ
Vic	ヴィク
Vicente	ビセンテ
Vicheal	ヴァイケル
Vick	ヴィック
Vickers	ヴィッカーズ
Vickerson	ヴィッカーソン
Vicki	ヴィッキー
Vickiel	ヴィッキール
Victor	ヴィクター
Victor	ビクター
Victor	ビクトル
Victorino	ビクトリノ
Vidal	ビダル
Vidro	ビドロ
Vieira	ヴィエイラ
Villanueva	ヴィリャヌエヴァ
Villanueva	ビラヌエバ
Villarreal	ヴィラリーアル
Villarreal	ビーヤレアル
Villarrial	ヴィラリアル
Ville	ヴィール
Vilma	ヴィルマ
Vinatieri	ヴィナティエリ
Vince	ヴィンス
Vincent	ヴィンセント
Vines	ヴァインズ
Vinnett	ヴィネット
Vinny	ヴィニー
Vinny	ビニー
Virgil	バージル
Visanthe	ヴィサンサ
Vitolo	ヴィトーロ
Vitt	ヴィット
Vladimir	ウラジーミル
Void	ヴォイド
Volek	ヴォレック
Vollers	ヴォラーズ
Vollmer	ボルマー
Volquez	ボルケス
Von	ヴォン
Voncarie	ヴォンキャリー
Vonnie	ヴォニー
vonOelhoffen	ヴォンオールホッフェン
Vonta	ヴォンタ
Vontae	ボンテ
Vontez	ヴォンテス
Vontrell	ヴォントレル
Votto	ヴォット
Vrabel	ヴラベル
Waddell	ワデール
Wade	ウェイド
Wadsworth	ウォズワース
Wages	ウェイジズ
Waggoner	ワゴナー
Wagner	ワグナー
Wahle	ウォール
Wahlroos	ウォールルーズ
Waine	ウェイン
Wake	ウェイク
Wakefield	ウェイクフィールド
Walden	ウォールデン
Wali	ワリ
Walker	ウォーカー
Wall	ウォール
Wallace	ウォレス
Waller	ウォーラー
Walls	ウォールズ
Walsh	ウォルシュ
Walt	ウォルト
Walter	ウォルター
Walters	ウォルターズ
Wand	ウォンド
Wandy	ワンディ
Wang	ワン
Wanja	ワーニャ
Wannstedt	ウォンステッド
Ward	ウォード
Ware	ウェア
Warfield	ウォーフィールド
Warford	ウォーフォード
Warhop	ウォーホップ
Warley	ウォーリー
Warner	ウォーナー
Warren	ウォーレン
Warrick	ウォリック
Wash	ウォッシュ
Washburn	ウォシュバーン
Washburn	ウォッシュバーン
Washington	ワシントン
Wassermann	ワッセルマン
Waterfield	ウォーターフィールド
Waters	ウォーターズ
Watje	ワッチェ
Watkins	ワトキンス
Watson	ワトソン
Watt	ワット
Watters	ワターズ
Watton	ワットン
Watts	ワッツ
Waufle	ワーフル
Wayne	ウェイン
Weakland	ウィークランド
Weary	ウィアリー
Weatherford	ウェザーフォード
Weathers	ウェザーズ
Weatherspoon	ウェザースプーン
Weaver	ウィーヴァー
Weaver	ウィーバー
Webb	ウェッブ
Weber	ウェーバー
Webster	ウェブスター
Weddle	ウェドル
Weeb	ウィーブ
Weeks	ウィークス
Weems	ウィームズ
Wehrli	ウェールリ
Wei	ウェイ
Weiner	ワイナー
Weinke	ウェインキー
Weis	ワイズ
Welbourn	ウェルボーン
Welker	ウェルカー
Wellington	ウェリントン
Wellock	ウェロック
Wells	ウェルズ
Welsh	ウェルシュ
Wendell	ウェンデル
Wendling	ウェントリング
Werner	ヴェルナー
Werth	ワース
Wes	ウェス
Wes	ウェズ
Wesley	ウェズリー
Wesly	ウェズリー
West	ウェスト
Westbrook	ウェストブルック
Westby	ウェストビー
Westerman	ウェスターマン
Westhoff	ウエストホフ
Westmoreland	ウェストモアランド
Whalen	ウェイレン
Wharton	ワートン
Wheatley	ウィートリー
Wheeler	ウィーラー
Whimper	ウィンパー
Whipple	ウィップル
Whisenhunt	ワイゼンハント
Whitaker	ウィテカー
White	ホワイト
Whitehead	ホワイトヘッド
Whitehurst	ホワイトハースト
Whiteside	ホワイトサイド
Whitey	ホワイティ
Whitfield	ウィットフィールド
Whitley	ウィットリー
Whitlock	ウィットロック
Whitmore	ウィットモア
Whitner	ウィットナー
Whitsell	ウィットセル
Whitsitt	ウィットシット
Whitt	ウィット
Whitted	ウィテッド
Whitticker	ウィティッカー
Whittle	ウィトル
Whitworth	ウィットワース
Wichard	ウィシャード
Wicker	ウィッカー
Wicks	ウィックス
Widenhofer	ウッデンホファー
Wied	ウィード
Wiedmeier	ウィードマイアー
Wiegert	ウィーガート
Wiegmann	ウィーグマン
Wiggins	ウィギンズ
Wigginton	ウィギントン
Wilber	ウィルバー
Wilbur	ウィルバー
Wilcots	ウィルコッツ
Wilcox	ウィルコックス
Wilder	ワイルダー
Wilds	ワイルズ
Wiley	ワイリー
Wilf	ウィルフ
Wilford	ウィルフォード
Wilfork	ウィルフォーク
Wilhelm	ウィルヘルム
Wilhite	ウィルハイト
Wilhoit	ウィルホイト
Wilkerson	ウィルカーソン
Wilkins	ウィルキンズ
Wilkinson	ウィルキンソン
Wilks	ウィルクス
Will	ウィル
William	ウィリアム
Williams	ウィリアムス
Williams	ウィリアムズ
Williamson	ウィリアムソン
Willie	ウィリー
Willig	ウィリグ
Willingham	ウィリンガム
Willingham	ウィリングハム
Willis	ウィリス
Willis	ウィリズ
Willits	ウィリッツ
Willy	ウィリー
Wilson	ウィルソン
WilyMo	ウィリーモー
Wimbley	ウィンブリー
Wimbush	ウィムブッシュ
Winborn	ウィンボーン
Winborne	ウィンボーン
Winchester	ウィンチェスター
Winey	ワイニー
Winfield	ウィンフィールド
Winkler	ヴィンクラー
Winslow	ウィンスロー
Winston	ウィンストン
Winston	ライアン
Winters	ウィンタース
Wire	ワイアー
Wise	ワイズ
Wishom	ウィショム
Wisniewski	ウィスニウスキー
Wistrcill	ウィスターシル
Wistrom	ウィストロム
Witasick	ウィタシック
Witherspoon	ウィザースプーン
Withrow	ウィズロウ
Witkowski	ウィトカウスキー
Witten	ウィッテン
Witzmann	ウィッツマン
Wladimir	ウラジーミル
Wolf	ウルフ
Wolfe	ウルフ
Wolford	ウォルフォード
Wollschlager	ウォルシュレイガー
Wolthausen	ウォルトハウゼン
Womack	ウォーマック
Wong	ウォング
Wood	ウッド
Woodard	ウッダード
Woodbury	ウッドバリー
Wooden	ウッデン
Woodfin	ウッドフィン
Woodhead	ウッドヘッド
Woodley	ウッドリー
Woods	ウッズ
Woodson	ウッドソン
Woodward	ウッドウォード
Woody	ウッディ
Woolfolk	ウルフォーク
Word	ワード
Worrell	ウォレール
Worsley	ワースリー
Wortham	ワーサム
Worthy	ワージー
Wragge	ラッジ
Wreh-Wilson	レーウィルソン
Wrighster	ライスター
Wright	ライト
Wrobel	ローベル
Wroten	ローテン
Wrotto	ロットー
Wuerffel	ワーフェル
Wuertz	ウェルツ
Wunsch	ヴンシュ
Wusu	ウースー
Wyatt	ワイアット
Wyche	ワイチ
Wylie	ワイリー
Wyllie	ワイリー
Wyms	ワイムズ
Wynn	ウィン
Xavien	ザビエン
Xavier	ゼイヴィアー
Xavier	ハビエル
x-Ramon	ラモン
Xzavie	エクスゼイヴィー
Y.A.	Y.A.
Yalei	ヤレイ
Yamon	ヤモン
Yancy	ヤンシー
Yanda	ヤンドゥ
Yarbrough	ヤーブロウ
Yates	イェーツ
Yates	イエーツ
Yee	イー
Yelk	イェルク
Yeremiah	イェレマイア
Yo	ヨー
Yoan	ヨアン
Yoder	ヨーダー
Yoel	ヨエル
Yogi	ヨウギ
York	ヨーク
Yorman	ヨルマン
Yoslan	ヨスラン
Youboty	ユーボーティ
Youkilis	ヨーキリス
Youman	ユーマン
Young	ヤング
Youngblood	ヤングブラッド
Yovani	ヨバニ
Yovanovits	ヨヴァノヴィッツ
Yuji	ユウジ
Yukhnovich	ユーハーノヴィッチ
Yunel	ユネル
Yuniesky	ユニエスキー
Zabel	ゼイベル
Zabransky	ザブランスキー
Zac	ザック
Zach	ザック
Zachary	ザカリー
Zack	ザック
Zagurski	ザグルスキ
Zak	ザック
Zalewski	ザレフスキー
Zamberletti	ザンバーレッティ
Zambrano	ザンブラーノ
Zamir	ザミール
Zampese	ザンピージー
Zarate	サラテ
Zarnell	ザーネル
Zastudil	ザストゥディル
Zaun	ザーン
Zauner	ザウナー
Zay	ゼイ
Zeigler	ジーグラー
Zeke	ジーク
Zelenka	ゼイレンカ
Zemaitis	ズーミテウス
Zereoue	ゼラウェイ
Zernhelt	ザーンヘルト
Zeron	ゼロン
Zgonina	スカニーナ
Zielinski	ジーリンスキー
Zierlein	ザイアーライン
Zigmunt	ジグムント
Zimmer	ジマー
Zimmerman	ジマーマン
Zimmerman	ツィマーマン
Zinger	ジンガー
Zombo	ゾンボ
Zorn	ゾーン
Zuckerman	ザッカーマン
Zumaya	ズマーヤ
Zuriel	ズリエル
Zwick	ズウィック
Zygmunt	ジグムント
